CGGAGATCTGGTGCGCTAG: GGAGATCTGGTGCGCTAGG
TAATTTCACCATGAGTTAG: AATTTCACCATGAGTTAGA
GGATAGGCAGAACCTTAGG: GATAGGCAGAACCTTAGGG
TCATACGAATCCAGCGTAT: CATACGAATCCAGCGTATT
ACATTAGAACATATTTCAC: CATTAGAACATATTTCACG
TTTGACTAGGGGAGTGTCG: TTGACTAGGGGAGTGTCGC
TACGTACGATAAGATCCTA: ACGTACGATAAGATCCTAT
GTTATCTACGACTAGTTAC: TTATCTACGACTAGTTACG
CGGGTACCCAGGCAGTAGA: GGGTACCCAGGCAGTAGAC
CAGGGGATTGGTTGAACCC: AGGGGATTGGTTGAACCCG
ACACAACCTAAAGAAGCGA: CACAACCTAAAGAAGCGAG
GGGAGTGTCGCACCACTGG: GGAGTGTCGCACCACTGGT
TGACGCACACCGGGCCTAA: GACGCACACCGGGCCTAAT
GTGGTCAGATCCACGCCCA: TGGTCAGATCCACGCCCAG
CGGGGGGTTTAGATAGAAA: GGGGGGTTTAGATAGAAAT
CGGAAATGGTGCATGCTCT: GGAAATGGTGCATGCTCTT
GAAGCCTCTTCGCAAAGAA: AAGCCTCTTCGCAAAGAAA
TTTACGAAAGAAGCCTCTT: TTACGAAAGAAGCCTCTTC
CAGGCAGTAGACCGAGGGG: AGGCAGTAGACCGAGGGGA
CCCAGGTCTCGTGAGGCAT: CCAGGTCTCGTGAGGCATG
AACACAACCGACATTAAGC: ACACAACCGACATTAAGCC
CAAGTCGACCTCCGCTTCC: AAGTCGACCTCCGCTTCCC
AGTGTCGCACCCCACCGAT: GTGTCGCACCCCACCGATT
TCGCGGATGATAACGACAG: CGCGGATGATAACGACAGC
GGTGCCAAGACTCGCGATA: GTGCCAAGACTCGCGATAC
GCCCGGGGTTCATCTACTA: CCCGGGGTTCATCTACTAG
GGGCCTAATCGCGTAAGAT: GGCCTAATCGCGTAAGATA
CACAATCCGCAGCTGTTGC: ACAATCCGCAGCTGTTGCA
TTTGGGCTAGCCGTATCCA: TTGGGCTAGCCGTATCCAT
GGGGAGTGTCGCACCGTCA: GGGAGTGTCGCACCGTCAG
GTGTGATCGTGGAGGGGGC: TGTGATCGTGGAGGGGGCT
TCCGTGTTGCCGGTCCAGG: CCGTGTTGCCGGTCCAGGA
TAGCCGTATCCATATCTGG: AGCCGTATCCATATCTGGC
ATTGAGACACAACCTAAAG: TTGAGACACAACCTAAAGA
AACCTTAGGGTTTTGCTGT: ACCTTAGGGTTTTGCTGTA
AGGGACATGGGTGCCAAGA: GGGACATGGGTGCCAAGAC
GTTCTACTGAGTCATAAGA: TTCTACTGAGTCATAAGAG
GCCGGTCCAGGAGGTTGTT: CCGGTCCAGGAGGTTGTTT
CGGAAGGGTTTCAGTCCGG: GGAAGGGTTTCAGTCCGGC
GACCTCCGCTTCCCATGAC: ACCTCCGCTTCCCATGACG
AGTGGGAACAAGTCGACCT: GTGGGAACAAGTCGACCTC
CTTCATTTACGGAGATCTG: TTCATTTACGGAGATCTGG
TTACGGTTGAATGTTTTTA: TACGGTTGAATGTTTTTAA
AGCAATGGTTATCGGTCTA: GCAATGGTTATCGGTCTAG
TGACAAAGGGACATGGGTG: GACAAAGGGACATGGGTGC
GTCGCACCACTGGTTGGCG: TCGCACCACTGGTTGGCGA
AGGCATGACCCTTTACGAA: GGCATGACCCTTTACGAAA
ATCGTGGAGGGGGCTCGCC: TCGTGGAGGGGGCTCGCCA
GTTTTGCTGTACCTAATGG: TTTTGCTGTACCTAATGGT
GCAGTAGACCGAGGGGATC: CAGTAGACCGAGGGGATCG
CCGCTCAGGATCCACAAGC: CGCTCAGGATCCACAAGCC
TAGGGCCCACTTTAATACG: AGGGCCCACTTTAATACGA
CATCGGTTCCGGTAAATAC: ATCGGTTCCGGTAAATACA
CACCTGGTGACTATGCTAG: ACCTGGTGACTATGCTAGT
GGGAGTGTCGCACCGTCAG: GGAGTGTCGCACCGTCAGA
CTGAATCCCTCATCAGCCG: TGAATCCCTCATCAGCCGT
TATTAGTCCCCGCGTTCTA: ATTAGTCCCCGCGTTCTAC
TTGTTAAATAATATAGAAG: TGTTAAATAATATAGAAGG
GGTGATTCCATCGGTTCCG: GTGATTCCATCGGTTCCGG
GTTGGCGAGTCGACCTCCG: TTGGCGAGTCGACCTCCGC
TGTACACAGAAATATGGCG: GTACACAGAAATATGGCGT
CCTCCGCTTCCCAGGTCTC: CTCCGCTTCCCAGGTCTCG
TCCAGGAGGTTGTTTTTGT: CCAGGAGGTTGTTTTTGTG
TAAGCTGCCGGAATCGGAC: AAGCTGCCGGAATCGGACA
AAGAACATGTCTAAACTGC: AGAACATGTCTAAACTGCT
ATCAGCCGTTCGCGCCTCT: TCAGCCGTTCGCGCCTCTT
CCCTGCTGGCGCCTACCAG: CCTGCTGGCGCCTACCAGG
AGGACTTGTTCCCACGTCG: GGACTTGTTCCCACGTCGA
CGCGAACGATGTCGCGGAA: GCGAACGATGTCGCGGAAA
ATCCATATCTGGCTTCATT: TCCATATCTGGCTTCATTG
ACAATAGATGGATAGGCAG: CAATAGATGGATAGGCAGA
CCTCATCGTAATTAACACC: CTCATCGTAATTAACACCC
GATGGCGCGCACTACACAA: ATGGCGCGCACTACACAAC
TTTGAATTTTTACACACGT: TTGAATTTTTACACACGTA
ACTAGGGGAGTGTCGCACC: CTAGGGGAGTGTCGCACCA
ATCCAGCGTATTGCCCCGT: TCCAGCGTATTGCCCCGTA
TTGGCGTATTAGTCCCCGC: TGGCGTATTAGTCCCCGCG
TAGTCTTTCTTAGGATCAA: AGTCTTTCTTAGGATCAAA
ATCGCAGTGTCGTCCTGCG: TCGCAGTGTCGTCCTGCGA
TAATACGAGCATAATTCAG: AATACGAGCATAATTCAGT
AGATGCGATGTTAACAGTG: GATGCGATGTTAACAGTGG
AGTAGACCGAGGGGATCGT: GTAGACCGAGGGGATCGTT
AGCCCATACTTCATTTACG: GCCCATACTTCATTTACGG
AGGACAGGGGATTGGTTGA: GGACAGGGGATTGGTTGAA
AAACCCGTAAAAGTAGGGG: AACCCGTAAAAGTAGGGGA
CGGATCTATCGACGAGGAA: GGATCTATCGACGAGGAAG
TCCTCGCGCACATTGCGAC: CCTCGCGCACATTGCGACG
GTCATCCAGAGTCTAGTCA: TCATCCAGAGTCTAGTCAG
CATTTACGGAGATCTGGTG: ATTTACGGAGATCTGGTGC
GTAGACCTTCCACGTTTAT: TAGACCTTCCACGTTTATA
CCCCAAGAATTGAGACACA: CCCAAGAATTGAGACACAA
AGTGGTTTGAATTTTTACA: GTGGTTTGAATTTTTACAC
TATGTCACTGACATCCGTG: ATGTCACTGACATCCGTGT
AGACGAAGCACGTATACCC: GACGAAGCACGTATACCCG
GTCAGCTCCATGTTTTGCT: TCAGCTCCATGTTTTGCTC
TCGGATGGCGCGCACTACA: CGGATGGCGCGCACTACAC
GTGAGCGCTCGGTGAGAGC: TGAGCGCTCGGTGAGAGCC
CAGCCGGCCTATAAGGAAA: AGCCGGCCTATAAGGAAAC
CGACCTCCGCTTCCCAGGT: GACCTCCGCTTCCCAGGTG GACCTCCGCTTCCCAGGTC
GCCTCTTACCAAATCAGGC: CCTCTTACCAAATCAGGCA
GGCCCCCTATCCTATGTCA: GCCCCCTATCCTATGTCAC
CTCTTACCAAATCAGGCAA: TCTTACCAAATCAGGCAAG
TACAGGGGGAGTCATCCAG: ACAGGGGGAGTCATCCAGA
TCGGTGAGAGCCCACAATA: CGGTGAGAGCCCACAATAG
GCCCCTCTTAGCGGTCTGG: CCCCTCTTAGCGGTCTGGA
GTGGGAACAAGTCGACCTC: TGGGAACAAGTCGACCTCC
CTTGAGTCAAAAGCCCTCA: TTGAGTCAAAAGCCCTCAG
ACGGTTCGGTGTGATCGTG: CGGTTCGGTGTGATCGTGG
ACGATATTCACCAATGCAC: CGATATTCACCAATGCACC
ATCTCGGGCCCCTCTTAGC: TCTCGGGCCCCTCTTAGCG
GAAGGGTGCTCTAGATATC: AAGGGTGCTCTAGATATCT
CTCATGTGCATCGGAAATG: TCATGTGCATCGGAAATGG
CTCCACCGCTGTTTGGGCT: TCCACCGCTGTTTGGGCTA
GGCCCCTCTTAGCGGTCTG: GCCCCTCTTAGCGGTCTGG
CTCATACGAATCCAGCGTA: TCATACGAATCCAGCGTAT
GACCTTCATCGCGGATGAT: ACCTTCATCGCGGATGATA
GGGATCGTTATCTACGACT: GGATCGTTATCTACGACTA
ACAGAAATATGGCGTAACA: CAGAAATATGGCGTAACAA
GAAAGAAGCCTCTTCGCAA: AAAGAAGCCTCTTCGCAAA
TGAATCCCTCATCAGCCGT: GAATCCCTCATCAGCCGTT
AATCGCAGTGTCGTCCTGC: ATCGCAGTGTCGTCCTGCG
CACCCTTTGTTAAACACAA: ACCCTTTGTTAAACACAAC
CGGCTTCCGGTTATAGGGC: GGCTTCCGGTTATAGGGCC
AGGTTAATGTCGAAACCCT: GGTTAATGTCGAAACCCTG
TCCGAGCTCAGCCGGCCTA: CCGAGCTCAGCCGGCCTAT
TTCATCGCGGATGATAACG: TCATCGCGGATGATAACGA
GTGCTCCGAGCTCAGCCGG: TGCTCCGAGCTCAGCCGGC
CACCACGACCTGAATCCCT: ACCACGACCTGAATCCCTC
GCTTCATTGCTAACGCGGG: CTTCATTGCTAACGCGGGA
CAGGCAAGCACCCTTTGTT: AGGCAAGCACCCTTTGTTA
GTACACAGAAATATGGCGT: TACACAGAAATATGGCGTA
CCCCTATCCTATGTCACTG: CCCTATCCTATGTCACTGA
GTGCTCTAGGTCCGGTGTC: TGCTCTAGGTCCGGTGTCA
TGCTTAAGGTTAATGTCGA: GCTTAAGGTTAATGTCGAA
TATAGAAGGCCCCCTATCC: ATAGAAGGCCCCCTATCCT
AACAGTGGTCACACGCTTG: ACAGTGGTCACACGCTTGG
AAAGTAGGGGACCACTCAT: AAGTAGGGGACCACTCATG
TAGGTCCGGTGTCACAACG: AGGTCCGGTGTCACAACGT
CTCACGTGAGCGACTGCGT: TCACGTGAGCGACTGCGTA
TCCTAGGGGAGTGTCGCAC: CCTAGGGGAGTGTCGCACC
CACTCATGTGCATCGGAAA: ACTCATGTGCATCGGAAAT
CTAGTGGTACCCTTGTGAA: TAGTGGTACCCTTGTGAAT
TGTACAGGGGGAGTCATCC: GTACAGGGGGAGTCATCCA
CGTATTAGTCCCCGCGTTC: GTATTAGTCCCCGCGTTCT
ATACGGGAGCTTGAGTCAA: TACGGGAGCTTGAGTCAAA
TGGGCTAGCCGTATCCATA: GGGCTAGCCGTATCCATAT
GTGAGCGACTGCGTAGACA: TGAGCGACTGCGTAGACAG
GGGCCCCTCTTAGCGGTCT: GGCCCCTCTTAGCGGTCTG
AATCAGGCAAGCACCCTTT: ATCAGGCAAGCACCCTTTG
AGTAGGGGACCACTCATGT: GTAGGGGACCACTCATGTG
ACCGGGCCTCAACGCTAGG: CCGGGCCTCAACGCTAGGA
GGGTTTAGATAGAAATTGT: GGTTTAGATAGAAATTGTA
AGATCTGGTGCGCTAGGGG: GATCTGGTGCGCTAGGGGA
TCGGTTCCGGTAAATACAT: CGGTTCCGGTAAATACATT
ATGCGATGAGAGTGGTTTG: TGCGATGAGAGTGGTTTGA
GGGGAGTCATCCAGAGTCT: GGGAGTCATCCAGAGTCTA
TTTGCTGTACCTAATGGTC: TTGCTGTACCTAATGGTCT
TGGTTTGAATTTTTACACA: GGTTTGAATTTTTACACAC
GTGAGAGCCCACAATAGAT: TGAGAGCCCACAATAGATG
GAAACAGCACAAGAGTGTA: AAACAGCACAAGAGTGTAG
GTAATTAACACCCAATCTT: TAATTAACACCCAATCTTC
ATCGGTCTAGGCTATTTTA: TCGGTCTAGGCTATTTTAT
ACCAGGCTGCTTGTTAAAT: CCAGGCTGCTTGTTAAATA
TTATCGGTCTAGGCTATTT: TATCGGTCTAGGCTATTTT
GCACCTGGTGACTATGCTA: CACCTGGTGACTATGCTAG
GCATGGTAATCGCAGTGTC: CATGGTAATCGCAGTGTCG
CCGCAGCTGTTGCATGGTA: CGCAGCTGTTGCATGGTAA
ATGCATGTGCTCCGAGCTC: TGCATGTGCTCCGAGCTCA
TGTCGTCCTGCGAGCAATG: GTCGTCCTGCGAGCAATGG
CTATCGACGAGGAAGGCGC: TATCGACGAGGAAGGCGCC
GGTTGAACCCGCAAGCTGA: GTTGAACCCGCAAGCTGAG
GATGTCGCGGAAAATCCAT: ATGTCGCGGAAAATCCATC
TTTACAGCAGTAAGTTCTT: TTACAGCAGTAAGTTCTTG
CACAATAGATGGATAGGCA: ACAATAGATGGATAGGCAG
AATCTTCCGGGGGGTTTAG: ATCTTCCGGGGGGTTTAGA
CCAATGCACCTGGTGACTA: CAATGCACCTGGTGACTAT
ACCCAGGCAGTAGACCGAG: CCCAGGCAGTAGACCGAGG
GTTCGAAGAACATGTCTAA: TTCGAAGAACATGTCTAAA
AAATATGGCGTAACAAGCG: AATATGGCGTAACAAGCGT
CTCGCGATACCCCAAGAAT: TCGCGATACCCCAAGAATT
TTCATTGCTAACGCGGGAT: TCATTGCTAACGCGGGATC
CGGTCTGGAAATCCTCGCG: GGTCTGGAAATCCTCGCGC
GCGGAAAATCCATCTTGCG: CGGAAAATCCATCTTGCGA
TGCCGGAATCGGACAACAC: GCCGGAATCGGACAACACC
CCTCCGCTTCCCAGGTGGC: CTCCGCTTCCCAGGTGGCT
GCGCACTACACAACGTAAC: CGCACTACACAACGTAACG
GGCGGAGTCGACCTCCGCT: GCGGAGTCGACCTCCGCTT
TAGGGGAGTGTCGCACCGT: AGGGGAGTGTCGCACCGTC
CCCGCAAGCTGAGTGCTTA: CCGCAAGCTGAGTGCTTAA
GGCTCGCCATTGCTCAGGA: GCTCGCCATTGCTCAGGAC
TTACGAAAGAAGCCTCTTC: TACGAAAGAAGCCTCTTCG
GCCTACCAGGCTGCTTGTT: CCTACCAGGCTGCTTGTTA
CCGGCTTCCGGTTATAGGG: CGGCTTCCGGTTATAGGGC
TGGCGCCTACCAGGCTGCT: GGCGCCTACCAGGCTGCTT
CTCATCGAGATGCGATGAG: TCATCGAGATGCGATGAGA
ATCGAGATGCGATGAGAGT: TCGAGATGCGATGAGAGTG
ACCACTCATGTGCATCGGA: CCACTCATGTGCATCGGAA
TGATCGTGGAGGGGGCTCG: GATCGTGGAGGGGGCTCGC
AACATATTTCACGGAAGAT: ACATATTTCACGGAAGATG
GCTAGGGGAGTGTCGCACC: CTAGGGGAGTGTCGCACCG
CATTGCTAACGCGGGATCT: ATTGCTAACGCGGGATCTT
AGGATCCACAAGCCCGGGG: GGATCCACAAGCCCGGGGT
CTGTGGTCAGATCCACGCC: TGTGGTCAGATCCACGCCC
GAAAAGTAGACCTTCCACG: AAAAGTAGACCTTCCACGT
GGAATCGGACAACACCAAC: GAATCGGACAACACCAACT
GCCTTTACAGCAGTAAGTT: CCTTTACAGCAGTAAGTTC
TAGTTTGACTAGGGGAGTG: AGTTTGACTAGGGGAGTGT
CACAAGCCCGGGGTTCATC: ACAAGCCCGGGGTTCATCT
AGTCGACCTCCGCTTCCCA: GTCGACCTCCGCTTCCCAT GTCGACCTCCGCTTCCCAT GTCGACCTCCGCTTCCCAG GTCGACCTCCGCTTCCCAG
AATGCACCTGGTGACTATG: ATGCACCTGGTGACTATGC
GTAACACAATCCGCAGCTG: TAACACAATCCGCAGCTGT
ACGTAACGCCTTTACAGCA: CGTAACGCCTTTACAGCAG
GTCTCACTGACGGTTCGGT: TCTCACTGACGGTTCGGTG
TGGGAACAAGTCGACCTCC: GGGAACAAGTCGACCTCCG
ACACGCTTGGCGTATTAGT: CACGCTTGGCGTATTAGTC
GAGTCAAAAGCCCTCAGCG: AGTCAAAAGCCCTCAGCGG
AAGCCCTCAGCGGGTACCC: AGCCCTCAGCGGGTACCCA
GCCCAGACTGAAACAGCAC: CCCAGACTGAAACAGCACA
AATATGGCGTAACAAGCGT: ATATGGCGTAACAAGCGTT
GGCGCCTACCAGGCTGCTT: GCGCCTACCAGGCTGCTTG
GTGCTCTAGATATCTTCAC: TGCTCTAGATATCTTCACC
GGCCCACTTTAATACGAGC: GCCCACTTTAATACGAGCA
GTGCGCTAGGGGAGTGTCG: TGCGCTAGGGGAGTGTCGC
TCAGGATCCACAAGCCCGG: CAGGATCCACAAGCCCGGG
GTGATTACTCGTGAGCGCT: TGATTACTCGTGAGCGCTC
AAGCCTCTTCGCAAAGAAA: AGCCTCTTCGCAAAGAAAA
TGCGTTGTCCTCATCGTAA: GCGTTGTCCTCATCGTAAT
ACTGACGGTTCGGTGTGAT: CTGACGGTTCGGTGTGATC
AGAGTGTAGTCTTTCTTAG: GAGTGTAGTCTTTCTTAGG
CTTGTTAAATAATATAGAA: TTGTTAAATAATATAGAAG
CATCCGTGTTGCCGGTCCA: ATCCGTGTTGCCGGTCCAG
AAGCGAGAAACGCGTATGC: AGCGAGAAACGCGTATGCA
AACCCTGCTGGCGCCTACC: ACCCTGCTGGCGCCTACCA
CGCACACCGGGCCTAATCG: GCACACCGGGCCTAATCGC
ATGCGATGTTAACAGTGGT: TGCGATGTTAACAGTGGTC
GAGTCATAAGAGTAAGCTG: AGTCATAAGAGTAAGCTGC
GCGCCCAAGCCGGACAGAC: CGCCCAAGCCGGACAGACG
ATAATATAGAAGGCCCCCT: TAATATAGAAGGCCCCCTA
CCTATCCTATGTCACTGAC: CTATCCTATGTCACTGACA
CAGACGAAGCACGTATACC: AGACGAAGCACGTATACCC
ACGTGATTACTCGTGAGCG: CGTGATTACTCGTGAGCGC
TTTTTAAACCCGTAAAAGT: TTTTAAACCCGTAAAAGTA
GGGTTCATCTACTAGATTA: GGTTCATCTACTAGATTAT
CTGACGCACACCGGGCCTA: TGACGCACACCGGGCCTAA
ATCGGTTCCGGTAAATACA: TCGGTTCCGGTAAATACAT
GAGTCATCCAGAGTCTAGT: AGTCATCCAGAGTCTAGTC
CCGATTTAAGTCGACCTCC: CGATTTAAGTCGACCTCCG
AGCCCTCAGCGGGTACCCA: GCCCTCAGCGGGTACCCAG
CAGGATCCACAAGCCCGGG: AGGATCCACAAGCCCGGGG
AGTAAGCTGCCGGAATCGG: GTAAGCTGCCGGAATCGGA
ACCCTTGTGAATGGGTTAA: CCCTTGTGAATGGGTTAAC
GTGTCACAACGTCCCATCT: TGTCACAACGTCCCATCTC
TTTAAGTCGACCTCCGCTT: TTAAGTCGACCTCCGCTTC
AACGCGTATGCATGTGCTC: ACGCGTATGCATGTGCTCC
GTTTAGATAGAAATTGTAC: TTTAGATAGAAATTGTACA
CAAGCGTTCGAAGAACATG: AAGCGTTCGAAGAACATGT
TATTCACCAATGCACCTGG: ATTCACCAATGCACCTGGT
TACCCAGGCAGTAGACCGA: ACCCAGGCAGTAGACCGAG
GGTGAGAGCCCACAATAGA: GTGAGAGCCCACAATAGAT
TTGGCGGGTGATTCCATCG: TGGCGGGTGATTCCATCGG
ATATCTGGCTTCATTGCTA: TATCTGGCTTCATTGCTAA
CGCTTCCCATGTGCGCTGC: GCTTCCCATGTGCGCTGCT
AGGCGGAGTCGACCTCCGC: GGCGGAGTCGACCTCCGCT
GTTTCAGTCCGGCTTCCGG: TTTCAGTCCGGCTTCCGGT
ACGAAGCACGTATACCCGC: CGAAGCACGTATACCCGCT
AATCCCTCATCAGCCGTTC: ATCCCTCATCAGCCGTTCG
TTTCAGTCCGGCTTCCGGT: TTCAGTCCGGCTTCCGGTT
CACCAACTCACGTGAGCGA: ACCAACTCACGTGAGCGAC
CCAAGCCGGACAGACGAAG: CAAGCCGGACAGACGAAGC
CTGTTGCATGGTAATCGCA: TGTTGCATGGTAATCGCAG
GTTAACAGTGGTCACACGC: TTAACAGTGGTCACACGCT
GTCGACCTCCGCTTCCCAG: TCGACCTCCGCTTCCCAGG TCGACCTCCGCTTCCCAGG
GGTGTCACAACGTCCCATC: GTGTCACAACGTCCCATCT
TGTTAAACACAACCGACAT: GTTAAACACAACCGACATT
TCATGTGCATCGGAAATGG: CATGTGCATCGGAAATGGT
ACGGATCTATCGACGAGGA: CGGATCTATCGACGAGGAA
GTTCATCTACTAGATTATT: TTCATCTACTAGATTATTC
GGCTTCATTGCTAACGCGG: GCTTCATTGCTAACGCGGG
CCGGTCCAGGAGGTTGTTT: CGGTCCAGGAGGTTGTTTT
AGTGGTCACACGCTTGGCG: GTGGTCACACGCTTGGCGT
GGAAGATGCGATGTTAACA: GAAGATGCGATGTTAACAG
GTATCCATATCTGGCTTCA: TATCCATATCTGGCTTCAT
TACAAGAAGGGTGCTCTAG: ACAAGAAGGGTGCTCTAGA
CATACTTCATTTACGGAGA: ATACTTCATTTACGGAGAT
CGGATGGCGCGCACTACAC: GGATGGCGCGCACTACACA
CCGCTGTTTGGGCTAGCCG: CGCTGTTTGGGCTAGCCGT
TTTGGCGGGTGATTCCATC: TTGGCGGGTGATTCCATCG
TTGGCGAGTCGACCTCCGC: TGGCGAGTCGACCTCCGCT
GGTAAATACATTAGAACAT: GTAAATACATTAGAACATA
GTTATCGGTCTAGGCTATT: TTATCGGTCTAGGCTATTT
ATACATTAGAACATATTTC: TACATTAGAACATATTTCA
AGAAGGGTGCTCTAGATAT: GAAGGGTGCTCTAGATATC
CAGCACAAGAGTGTAGTCT: AGCACAAGAGTGTAGTCTT
AAGCTGCCGGAATCGGACA: AGCTGCCGGAATCGGACAA
CTAGGGGAGTGTCGCACCG: TAGGGGAGTGTCGCACCGT
TTCGGTGTGATCGTGGAGG: TCGGTGTGATCGTGGAGGG
TGACGTGATTACTCGTGAG: GACGTGATTACTCGTGAGC
ATCCTATGTCACTGACATC: TCCTATGTCACTGACATCC
CACTACACAACGTAACGCC: ACTACACAACGTAACGCCT
TTACTCGTGAGCGCTCGGT: TACTCGTGAGCGCTCGGTG
TGCTGGCGCCTACCAGGCT: GCTGGCGCCTACCAGGCTG
GAAGGGTTTCAGTCCGGCT: AAGGGTTTCAGTCCGGCTT
CTCGCCATTGCTCAGGACT: TCGCCATTGCTCAGGACTT
CAGGTCTCGTGAGGCATGA: AGGTCTCGTGAGGCATGAC
GCCCTCAGCGGGTACCCAG: CCCTCAGCGGGTACCCAGG
CTAGCCGTATCCATATCTG: TAGCCGTATCCATATCTGG
TACGACTAGTTACGGTTGA: ACGACTAGTTACGGTTGAA
ATGGCGCGCACTACACAAC: TGGCGCGCACTACACAACG
GACCCTTTACGAAAGAAGC: ACCCTTTACGAAAGAAGCC
TTGCTGACGCACACCGGGC: TGCTGACGCACACCGGGCC
GACAGTCGACTACAAGAAG: ACAGTCGACTACAAGAAGG
TCGCACCTAGTGGGAACAA: CGCACCTAGTGGGAACAAG
TTCTACTGAGTCATAAGAG: TCTACTGAGTCATAAGAGT
ACGTTAATTTCACCATGAG: CGTTAATTTCACCATGAGT
TAGGGGAGTGTCGCACCCC: AGGGGAGTGTCGCACCCCA
AAAAGTAGGGGACCACTCA: AAAGTAGGGGACCACTCAT
GCGGAGTCGACCTCCGCTT: CGGAGTCGACCTCCGCTTC
CCTCTTACCAAATCAGGCA: CTCTTACCAAATCAGGCAA
CCCCCTATCCTATGTCACT: CCCCTATCCTATGTCACTG
AAATACATTAGAACATATT: AATACATTAGAACATATTT
CAGCGTATTGCCCCGTACG: AGCGTATTGCCCCGTACGT
TACAGCAGTAAGTTCTTGC: ACAGCAGTAAGTTCTTGCT
TAGAACATATTTCACGGAA: AGAACATATTTCACGGAAG
GTACGTTAATTTCACCATG: TACGTTAATTTCACCATGA
GTAGGGGACCACTCATGTG: TAGGGGACCACTCATGTGC
AATTCAGTGCGTTGTCCTC: ATTCAGTGCGTTGTCCTCA
AAATAATATAGAAGGCCCC: AATAATATAGAAGGCCCCC
AACCCGCAAGCTGAGTGCT: ACCCGCAAGCTGAGTGCTT
TATCCTATGTCACTGACAT: ATCCTATGTCACTGACATC
TATGCTAGTGGTACCCTTG: ATGCTAGTGGTACCCTTGT
GCGATACCCCAAGAATTGA: CGATACCCCAAGAATTGAG
CTGAGTGCTTAAGGTTAAT: TGAGTGCTTAAGGTTAATG
CCGCAAGCTGAGTGCTTAA: CGCAAGCTGAGTGCTTAAG
CACCTAGTGGGAACAAGTC: ACCTAGTGGGAACAAGTCG
CGGGGTTCATCTACTAGAT: GGGGTTCATCTACTAGATT
CAGCTGTTGCATGGTAATC: AGCTGTTGCATGGTAATCG
GATCCACAAGCCCGGGGTT: ATCCACAAGCCCGGGGTTC
TTAAGTCGACCTCCGCTTC: TAAGTCGACCTCCGCTTCC
TAACGACAGCCCGGCTATA: AACGACAGCCCGGCTATAC
CGTAAAAGTAGGGGACCAC: GTAAAAGTAGGGGACCACT
CCAACTCACGTGAGCGACT: CAACTCACGTGAGCGACTG
TGGCTCTTTACTTAGTTTG: GGCTCTTTACTTAGTTTGA
GCGTTCTACTGAGTCATAA: CGTTCTACTGAGTCATAAG
TCTTAGCGGTCTGGAAATC: CTTAGCGGTCTGGAAATCC
TAGATATCTTCACCACGAC: AGATATCTTCACCACGACC
AGGCAAGCACCCTTTGTTA: GGCAAGCACCCTTTGTTAA
AGAAGGCCCCCTATCCTAT: GAAGGCCCCCTATCCTATG
CCTGCTGGCGCCTACCAGG: CTGCTGGCGCCTACCAGGC
TGCATGCTCTTAATGCCTC: GCATGCTCTTAATGCCTCC
CGGTTCCGGTAAATACATT: GGTTCCGGTAAATACATTA
GATTATTCACAATGACCTT: ATTATTCACAATGACCTTC
GTCGACTACAAGAAGGGTG: TCGACTACAAGAAGGGTGC
GACACAACCTAAAGAAGCG: ACACAACCTAAAGAAGCGA
TTTTGCTCATACGAATCCA: TTTGCTCATACGAATCCAG
TCATTTACGGAGATCTGGT: CATTTACGGAGATCTGGTG
AATTTCACCATGAGTTAGA: ATTTCACCATGAGTTAGAC
CTACAAGAAGGGTGCTCTA: TACAAGAAGGGTGCTCTAG
ACCGTCAGAGGCGGAGTCG: CCGTCAGAGGCGGAGTCGA
GCAATGGTTATCGGTCTAG: CAATGGTTATCGGTCTAGG
TTTCACGGAAGATGCGATG: TTCACGGAAGATGCGATGT
AATGGGTTAACAGTAGTTT: ATGGGTTAACAGTAGTTTT
ACACTGACAAAGGGACATG: CACTGACAAAGGGACATGG
GGTACCCAGGCAGTAGACC: GTACCCAGGCAGTAGACCG
ATCTATCGACGAGGAAGGC: TCTATCGACGAGGAAGGCG
CTGTACCTAATGGTCTCAC: TGTACCTAATGGTCTCACT
ACAAAGGGACATGGGTGCC: CAAAGGGACATGGGTGCCA
TCTAGTCAGCTCCATGTTT: CTAGTCAGCTCCATGTTTT
GTGATTCCATCGGTTCCGG: TGATTCCATCGGTTCCGGT
CAATGGTTATCGGTCTAGG: AATGGTTATCGGTCTAGGC
AGGGTGCTCTAGATATCTT: GGGTGCTCTAGATATCTTC
TCCAGCGTATTGCCCCGTA: CCAGCGTATTGCCCCGTAC
CGGGCCCCTCTTAGCGGTC: GGGCCCCTCTTAGCGGTCT
CGTGAGCGCTCGGTGAGAG: GTGAGCGCTCGGTGAGAGC
GAGCCCACAATAGATGGAT: AGCCCACAATAGATGGATA
CCCTCAGCGGGTACCCAGG: CCTCAGCGGGTACCCAGGC
TGGTAATCGCAGTGTCGTC: GGTAATCGCAGTGTCGTCC
GATGTTAACAGTGGTCACA: ATGTTAACAGTGGTCACAC
TACTTAGTTTGACTAGGGG: ACTTAGTTTGACTAGGGGA
ATGTTTTTAAACCCGTAAA: TGTTTTTAAACCCGTAAAA
CCACGACCTGAATCCCTCA: CACGACCTGAATCCCTCAT
AGAAATTGTACACAGAAAT: GAAATTGTACACAGAAATA
TATGCATGTGCTCCGAGCT: ATGCATGTGCTCCGAGCTC
AGACACAACCTAAAGAAGC: GACACAACCTAAAGAAGCG
TTTTGGCGGGTGATTCCAT: TTTGGCGGGTGATTCCATC
CTCAGCCGGCCTATAAGGA: TCAGCCGGCCTATAAGGAA
TGTTTGGGCTAGCCGTATC: GTTTGGGCTAGCCGTATCC
TTCCCAGGTCTCGTGAGGC: TCCCAGGTCTCGTGAGGCA
CGCACCGTCAGAGGCGGAG: GCACCGTCAGAGGCGGAGT
GCGACGTACTAGTCTCATC: CGACGTACTAGTCTCATCG
AAAGAAGCCTCTTCGCAAA: AAGAAGCCTCTTCGCAAAG
CTGACATCCGTGTTGCCGG: TGACATCCGTGTTGCCGGT
GCCGTATCCATATCTGGCT: CCGTATCCATATCTGGCTT
TATTTCACGGAAGATGCGA: ATTTCACGGAAGATGCGAT
CGGATGATAACGACAGCCC: GGATGATAACGACAGCCCG
GCTGCCGGAATCGGACAAC: CTGCCGGAATCGGACAACA
TTGTGAATGGGTTAACAGT: TGTGAATGGGTTAACAGTA
AATTGAGACACAACCTAAA: ATTGAGACACAACCTAAAG
TAAACCCGTAAAAGTAGGG: AAACCCGTAAAAGTAGGGG
AGACTCGCGATACCCCAAG: GACTCGCGATACCCCAAGA
CAGTAAGTTCTTGCTGACG: AGTAAGTTCTTGCTGACGC
GATCAAACAGTAACGTAAC: ATCAAACAGTAACGTAACA
TCCGCTTCCCAGGTGGCTC: CCGCTTCCCAGGTGGCTCT
CCACTCATGTGCATCGGAA: CACTCATGTGCATCGGAAA
GTTCTTGCTGACGCACACC: TTCTTGCTGACGCACACCG
ATAAGATCCTATGCGGATA: TAAGATCCTATGCGGATAC
ACGCACACCGGGCCTAATC: CGCACACCGGGCCTAATCG
TGGTGACTATGCTAGTGGT: GGTGACTATGCTAGTGGTA
GTACCCTTGTGAATGGGTT: TACCCTTGTGAATGGGTTA
ATACGAATCCAGCGTATTG: TACGAATCCAGCGTATTGC
GAGTGTCGCACCGTCAGAG: AGTGTCGCACCGTCAGAGG
TTATAGGGCCCACTTTAAT: TATAGGGCCCACTTTAATA
TTTATTGCTCCTTGATGTA: TTATTGCTCCTTGATGTAG
GCTAGTGGTACCCTTGTGA: CTAGTGGTACCCTTGTGAA
GATAGAAATTGTACACAGA: ATAGAAATTGTACACAGAA
CAGGTGGCTCTTTACTTAG: AGGTGGCTCTTTACTTAGT
CCTAATGGTCTCACTGACG: CTAATGGTCTCACTGACGG
AGATGCGATGAGAGTGGTT: GATGCGATGAGAGTGGTTT
GTCGACCTCCGCTTCCCAT: TCGACCTCCGCTTCCCATG TCGACCTCCGCTTCCCATG
CAGGCTGCTTGTTAAATAA: AGGCTGCTTGTTAAATAAT
TAGTTTTGGCGGGTGATTC: AGTTTTGGCGGGTGATTCC
ACTAGTTACGGTTGAATGT: CTAGTTACGGTTGAATGTT
TGCTAACGCGGGATCTTCT: GCTAACGCGGGATCTTCTA
CAGACTGAAACAGCACAAG: AGACTGAAACAGCACAAGA
TACGGTTGAATGTTTTTAA: ACGGTTGAATGTTTTTAAA
CGCTTCCCAGGTCTCGTGA: GCTTCCCAGGTCTCGTGAG
GCATGCTCTTAATGCCTCC: CATGCTCTTAATGCCTCCT
CCACTGGTTGGCGAGTCGA: CACTGGTTGGCGAGTCGAC
CCAATCTTCCGGGGGGTTT: CAATCTTCCGGGGGGTTTA
CTAATCGCGTAAGATACCG: TAATCGCGTAAGATACCGG
ATACGAGCATAATTCAGTG: TACGAGCATAATTCAGTGC
TCGTCCTGCGAGCAATGGT: CGTCCTGCGAGCAATGGTT
AGTCTCATCGAGATGCGAT: GTCTCATCGAGATGCGATG
GCACATTGCGACGTACTAG: CACATTGCGACGTACTAGT
GGGGTTTAGATAGAAATTG: GGGTTTAGATAGAAATTGT
CACGTGAGCGACTGCGTAG: ACGTGAGCGACTGCGTAGA
GTCTTTCTTAGGATCAAAC: TCTTTCTTAGGATCAAACA
GTCAGAGGCGGAGTCGACC: TCAGAGGCGGAGTCGACCT
CGGCTATACGGGAGCTTGA: GGCTATACGGGAGCTTGAG
AGATACCGGGCCTCAACGC: GATACCGGGCCTCAACGCT
TAGGACAGGGGATTGGTTG: AGGACAGGGGATTGGTTGA
CGCACCCCACCGATTTAAG: GCACCCCACCGATTTAAGT
TTAGACTGCGGAAGGGTTT: TAGACTGCGGAAGGGTTTC
GGATCAAACAGTAACGTAA: GATCAAACAGTAACGTAAC
GCACCTCCACCGCTGTTTG: CACCTCCACCGCTGTTTGG
CCATGTGCGCTGCTACGAA: CATGTGCGCTGCTACGAAC
GGATCGTTATCTACGACTA: GATCGTTATCTACGACTAG
AGTCAGCTCCATGTTTTGC: GTCAGCTCCATGTTTTGCT
TTACGGAGATCTGGTGCGC: TACGGAGATCTGGTGCGCT
GCTATACGGGAGCTTGAGT: CTATACGGGAGCTTGAGTC
ACAGTGGTCACACGCTTGG: CAGTGGTCACACGCTTGGC
GCTAGCCGTATCCATATCT: CTAGCCGTATCCATATCTG
ACCGACATTAAGCCCATAC: CCGACATTAAGCCCATACT
CGACTGCGTAGACAGTCGA: GACTGCGTAGACAGTCGAC
TGGAAATCCTCGCGCACAT: GGAAATCCTCGCGCACATT
TGGGTTAACAGTAGTTTTG: GGGTTAACAGTAGTTTTGG
GGTCTCGTGAGGCATGACC: GTCTCGTGAGGCATGACCC
GCGGATACGATATTCACCA: CGGATACGATATTCACCAA
CCGGGGGGTTTAGATAGAA: CGGGGGGTTTAGATAGAAA
CGAAACCCTGCTGGCGCCT: GAAACCCTGCTGGCGCCTA
TGCGACGTACTAGTCTCAT: GCGACGTACTAGTCTCATC
AGGTCTCGTGAGGCATGAC: GGTCTCGTGAGGCATGACC
GAAATTGTACACAGAAATA: AAATTGTACACAGAAATAT
CTGCTCATGCACCTCCACC: TGCTCATGCACCTCCACCG
CCTATGTCACTGACATCCG: CTATGTCACTGACATCCGT
TTCTTGCTGACGCACACCG: TCTTGCTGACGCACACCGG
CTTGGCGTATTAGTCCCCG: TTGGCGTATTAGTCCCCGC
TCTTTCTTAGGATCAAACA: CTTTCTTAGGATCAAACAG
CGGACAGACGAAGCACGTA: GGACAGACGAAGCACGTAT
GACCTTCCACGTTTATACG: ACCTTCCACGTTTATACGG
CACTTTAATACGAGCATAA: ACTTTAATACGAGCATAAT
TGAATTTTTACACACGTAC: GAATTTTTACACACGTACG
GCAGAACCTTAGGGTTTTG: CAGAACCTTAGGGTTTTGC
TCCCCGCGTTCTACTGAGT: CCCCGCGTTCTACTGAGTC
CCCGTAAAAGTAGGGGACC: CCGTAAAAGTAGGGGACCA
AGGGTTTCAGTCCGGCTTC: GGGTTTCAGTCCGGCTTCC
CGACCTGAATCCCTCATCA: GACCTGAATCCCTCATCAG
CACAACGTCCCATCTCGGG: ACAACGTCCCATCTCGGGC
TGGCGTATTAGTCCCCGCG: GGCGTATTAGTCCCCGCGT
AATGACCTTCATCGCGGAT: ATGACCTTCATCGCGGATG
TGAGCGCTCGGTGAGAGCC: GAGCGCTCGGTGAGAGCCC
ACACAATCCGCAGCTGTTG: CACAATCCGCAGCTGTTGC
GAATCCCTCATCAGCCGTT: AATCCCTCATCAGCCGTTC
CGAAGCACGTATACCCGCT: GAAGCACGTATACCCGCTC
CTTAGGGTTTTGCTGTACC: TTAGGGTTTTGCTGTACCT
CCCACTTTAATACGAGCAT: CCACTTTAATACGAGCATA
AAGAAGGGTGCTCTAGATA: AGAAGGGTGCTCTAGATAT
CGCTGTTTGGGCTAGCCGT: GCTGTTTGGGCTAGCCGTA
GTCTCGTGAGGCATGACCC: TCTCGTGAGGCATGACCCT
GACAGACGAAGCACGTATA: ACAGACGAAGCACGTATAC
AGCGTATTGCCCCGTACGT: GCGTATTGCCCCGTACGTA
CGTCAGAGGCGGAGTCGAC: GTCAGAGGCGGAGTCGACC
AAGATCCTATGCGGATACG: AGATCCTATGCGGATACGA
CATTAAGCCCATACTTCAT: ATTAAGCCCATACTTCATT
TCGTGAGGCATGACCCTTT: CGTGAGGCATGACCCTTTA
CGGACAACACCAACTCACG: GGACAACACCAACTCACGT
CTCAGGACTTGTTCCCACG: TCAGGACTTGTTCCCACGT
TTGATGTAGGACAGGGGAT: TGATGTAGGACAGGGGATT
GAAATCCTCGCGCACATTG: AAATCCTCGCGCACATTGC
ACCGGGCCTAATCGCGTAA: CCGGGCCTAATCGCGTAAG
GCTGTTGCATGGTAATCGC: CTGTTGCATGGTAATCGCA
TAGACAGTCGACTACAAGA: AGACAGTCGACTACAAGAA
GCAGTGTCGTCCTGCGAGC: CAGTGTCGTCCTGCGAGCA
ACAGCCCGGCTATACGGGA: CAGCCCGGCTATACGGGAG
ACTACAAGAAGGGTGCTCT: CTACAAGAAGGGTGCTCTA
ATAATTCAGTGCGTTGTCC: TAATTCAGTGCGTTGTCCT
GGACTTGTTCCCACGTCGA: GACTTGTTCCCACGTCGAG
GAATGGGTTAACAGTAGTT: AATGGGTTAACAGTAGTTT
CCTCCGCTTCCCATGACGT: CTCCGCTTCCCATGACGTG
GCACAAGAGTGTAGTCTTT: CACAAGAGTGTAGTCTTTC
TGTTTTGCTCATACGAATC: GTTTTGCTCATACGAATCC
TTCATTTACGGAGATCTGG: TCATTTACGGAGATCTGGT
AGACCTTCCACGTTTATAC: GACCTTCCACGTTTATACG
AAAGTAGACCTTCCACGTT: AAGTAGACCTTCCACGTTT
GGACATGGGTGCCAAGACT: GACATGGGTGCCAAGACTC
CAAGAATTGAGACACAACC: AAGAATTGAGACACAACCT
GGAGTGTCGCACCCCACCG: GAGTGTCGCACCCCACCGA
CAAAAGCCCTCAGCGGGTA: AAAAGCCCTCAGCGGGTAC
ATCGCGTAAGATACCGGGC: TCGCGTAAGATACCGGGCC
GGAGGGGGCTCGCCATTGC: GAGGGGGCTCGCCATTGCT
CAAGCCCGGGGTTCATCTA: AAGCCCGGGGTTCATCTAC
CGGTCTAGGCTATTTTATT: GGTCTAGGCTATTTTATTG
GTAGTCTTTCTTAGGATCA: TAGTCTTTCTTAGGATCAA
CTTAGGATCAAACAGTAAC: TTAGGATCAAACAGTAACG
TCATGCACCTCCACCGCTG: CATGCACCTCCACCGCTGT
TACACACGTACGTTAATTT: ACACACGTACGTTAATTTC
GGTTATAGGGCCCACTTTA: GTTATAGGGCCCACTTTAA
TGAAACAGCACAAGAGTGT: GAAACAGCACAAGAGTGTA
GACATGGGTGCCAAGACTC: ACATGGGTGCCAAGACTCG
GTTTTGGCGGGTGATTCCA: TTTTGGCGGGTGATTCCAT
CGGTAAATACATTAGAACA: GGTAAATACATTAGAACAT
TTAATTTCACCATGAGTTA: TAATTTCACCATGAGTTAG
GATCGTTATCTACGACTAG: ATCGTTATCTACGACTAGT
CCACCGCTGTTTGGGCTAG: CACCGCTGTTTGGGCTAGC
ACCTCCGCTTCCCAGGTCT: CCTCCGCTTCCCAGGTCTC
GCCCATACTTCATTTACGG: CCCATACTTCATTTACGGA
GAGGCGGAGTCGACCTCCG: AGGCGGAGTCGACCTCCGC
GTATTGCCCCGTACGTACG: TATTGCCCCGTACGTACGA
TAGGCTATTTTATTGCTCC: AGGCTATTTTATTGCTCCT
TAGACCTTCCACGTTTATA: AGACCTTCCACGTTTATAC
GGGGAGTGTCGCACCTAGT: GGGAGTGTCGCACCTAGTG
AAATGGTGCATGCTCTTAA: AATGGTGCATGCTCTTAAT
CTGCGAGCAATGGTTATCG: TGCGAGCAATGGTTATCGG
TCTGGCTTCATTGCTAACG: CTGGCTTCATTGCTAACGC
AAGAAGCGAGAAACGCGTA: AGAAGCGAGAAACGCGTAT
AGAATTGAGACACAACCTA: GAATTGAGACACAACCTAA
TCGCCATTGCTCAGGACTT: CGCCATTGCTCAGGACTTG
GGCTCTTTACTTAGTTTGA: GCTCTTTACTTAGTTTGAC
TGTCACAACGTCCCATCTC: GTCACAACGTCCCATCTCG
TACACAGAAATATGGCGTA: ACACAGAAATATGGCGTAA
TCGGTCTAGGCTATTTTAT: CGGTCTAGGCTATTTTATT
AGATCCACGCCCAGACTGA: GATCCACGCCCAGACTGAA
CTAGTCTCATCGAGATGCG: TAGTCTCATCGAGATGCGA
TGGTCACACGCTTGGCGTA: GGTCACACGCTTGGCGTAT
AGAACCTTAGGGTTTTGCT: GAACCTTAGGGTTTTGCTG
CTGCTTGTTAAATAATATA: TGCTTGTTAAATAATATAG
TTCCATCGGTTCCGGTAAA: TCCATCGGTTCCGGTAAAT
GAGTGCTTAAGGTTAATGT: AGTGCTTAAGGTTAATGTC
CGCGTATGCATGTGCTCCG: GCGTATGCATGTGCTCCGA
AGATTATTCACAATGACCT: GATTATTCACAATGACCTT
GCTGTACCTAATGGTCTCA: CTGTACCTAATGGTCTCAC
TTTGTGCTCTAGGTCCGGT: TTGTGCTCTAGGTCCGGTG
ATCAAACAGTAACGTAACA: TCAAACAGTAACGTAACAC
TTTCACCATGAGTTAGACT: TTCACCATGAGTTAGACTG
TAACACAATCCGCAGCTGT: AACACAATCCGCAGCTGTT
GGGGGCTCGCCATTGCTCA: GGGGCTCGCCATTGCTCAG
GTGATCGTGGAGGGGGCTC: TGATCGTGGAGGGGGCTCG
AGAGTCTAGTCAGCTCCAT: GAGTCTAGTCAGCTCCATG
GCTCTTAATGCCTCCTAGG: CTCTTAATGCCTCCTAGGG
TGCTCATGCACCTCCACCG: GCTCATGCACCTCCACCGC
AGTAGTTTTGGCGGGTGAT: GTAGTTTTGGCGGGTGATT
GCTGCTACGAACACTGACA: CTGCTACGAACACTGACAA
CCAGGCTGCTTGTTAAATA: CAGGCTGCTTGTTAAATAA
TTAGGATCAAACAGTAACG: TAGGATCAAACAGTAACGT
GCCATTGCTCAGGACTTGT: CCATTGCTCAGGACTTGTT
ATCGTAATTAACACCCAAT: TCGTAATTAACACCCAATC
GGGTTTTGCTGTACCTAAT: GGTTTTGCTGTACCTAATG
CGAGTCGACCTCCGCTTCC: GAGTCGACCTCCGCTTCCC
ACAGCACAAGAGTGTAGTC: CAGCACAAGAGTGTAGTCT
AGCACGTATACCCGCTCAG: GCACGTATACCCGCTCAGG
CCGCTTCCCATGACGTGAT: CGCTTCCCATGACGTGATT
GCCCACAATAGATGGATAG: CCCACAATAGATGGATAGG
TGCCTCCTAGGGGAGTGTC: GCCTCCTAGGGGAGTGTCG
GCTCCGAGCTCAGCCGGCC: CTCCGAGCTCAGCCGGCCT
TGCTCCGAGCTCAGCCGGC: GCTCCGAGCTCAGCCGGCC
AACAGTAACGTAACACAAT: ACAGTAACGTAACACAATC
CTCCTTGATGTAGGACAGG: TCCTTGATGTAGGACAGGG
AGGCGCCCAAGCCGGACAG: GGCGCCCAAGCCGGACAGA
ATTCAGTGCGTTGTCCTCA: TTCAGTGCGTTGTCCTCAT
ACTTTAATACGAGCATAAT: CTTTAATACGAGCATAATT
CCCATCTCGGGCCCCTCTT: CCATCTCGGGCCCCTCTTA
CCCCTCTTAGCGGTCTGGA: CCCTCTTAGCGGTCTGGAA
AGCTCCATGTTTTGCTCAT: GCTCCATGTTTTGCTCATA
CTACTGAGTCATAAGAGTA: TACTGAGTCATAAGAGTAA
AACATGTCTAAACTGCTCA: ACATGTCTAAACTGCTCAT
CGTACTAGTCTCATCGAGA: GTACTAGTCTCATCGAGAT
CGGGCCTAATCGCGTAAGA: GGGCCTAATCGCGTAAGAT
AATTGTACACAGAAATATG: ATTGTACACAGAAATATGG
CAGGTCTCCTAATACTGTG: AGGTCTCCTAATACTGTGG
GAGCTTGAGTCAAAAGCCC: AGCTTGAGTCAAAAGCCCT
TGCGCTAGGGGAGTGTCGC: GCGCTAGGGGAGTGTCGCA
GTGTCGCACCCCACCGATT: TGTCGCACCCCACCGATTT
AGTCAAAAGCCCTCAGCGG: GTCAAAAGCCCTCAGCGGG
ACGACTAGTTACGGTTGAA: CGACTAGTTACGGTTGAAT
CTTCCCATGTGCGCTGCTA: TTCCCATGTGCGCTGCTAC
CTGAAACAGCACAAGAGTG: TGAAACAGCACAAGAGTGT
CCAGGAGGTTGTTTTTGTG: CAGGAGGTTGTTTTTGTGC
CGCGCCTCTTACCAAATCA: GCGCCTCTTACCAAATCAG
CTCCTAATACTGTGGTCAG: TCCTAATACTGTGGTCAGA
GAGAGTGGTTTGAATTTTT: AGAGTGGTTTGAATTTTTA
GCTGGCGCCTACCAGGCTG: CTGGCGCCTACCAGGCTGC
CTACGACTAGTTACGGTTG: TACGACTAGTTACGGTTGA
GGACAGGGGATTGGTTGAA: GACAGGGGATTGGTTGAAC
GTTAACAGTAGTTTTGGCG: TTAACAGTAGTTTTGGCGG
GGCGCCCAAGCCGGACAGA: GCGCCCAAGCCGGACAGAC
CCTCGCGCACATTGCGACG: CTCGCGCACATTGCGACGT
TGAGTCAAAAGCCCTCAGC: GAGTCAAAAGCCCTCAGCG
TACGATAAGATCCTATGCG: ACGATAAGATCCTATGCGG
AGGTTGTTTTTGTGCTCTA: GGTTGTTTTTGTGCTCTAG
CTCCGCTTCCCAGGTCTCG: TCCGCTTCCCAGGTCTCGT
GGAGTGTCGCACCGTCAGA: GAGTGTCGCACCGTCAGAG
CTCAGGATCCACAAGCCCG: TCAGGATCCACAAGCCCGG
ACGAGCATAATTCAGTGCG: CGAGCATAATTCAGTGCGT
GTAACGCCTTTACAGCAGT: TAACGCCTTTACAGCAGTA
TTTTAAACCCGTAAAAGTA: TTTAAACCCGTAAAAGTAG
GTAAATACATTAGAACATA: TAAATACATTAGAACATAT
TGCGATGAGAGTGGTTTGA: GCGATGAGAGTGGTTTGAA
GTAGGACAGGGGATTGGTT: TAGGACAGGGGATTGGTTG
GACAGGGGATTGGTTGAAC: ACAGGGGATTGGTTGAACC
CAACGTAACGCCTTTACAG: AACGTAACGCCTTTACAGC
CCCATACTTCATTTACGGA: CCATACTTCATTTACGGAG
CCGGACAGACGAAGCACGT: CGGACAGACGAAGCACGTA
ACCTAAAGAAGCGAGAAAC: CCTAAAGAAGCGAGAAACG
TATCGACGAGGAAGGCGCC: ATCGACGAGGAAGGCGCCC
GCGCTAGGGGAGTGTCGCA: CGCTAGGGGAGTGTCGCAC
CCGGCTATACGGGAGCTTG: CGGCTATACGGGAGCTTGA
GTCGAGCGCGAACGATGTC: TCGAGCGCGAACGATGTCG
CCTCCGCTTCCCATGTGCG: CTCCGCTTCCCATGTGCGC
ATGACGTGATTACTCGTGA: TGACGTGATTACTCGTGAG
AACGATGTCGCGGAAAATC: ACGATGTCGCGGAAAATCC
ATCCACAAGCCCGGGGTTC: TCCACAAGCCCGGGGTTCA
TCGCGGAAAATCCATCTTG: CGCGGAAAATCCATCTTGC
CAGTGGTCACACGCTTGGC: AGTGGTCACACGCTTGGCG
TTTAATACGAGCATAATTC: TTAATACGAGCATAATTCA
GACGGTTCGGTGTGATCGT: ACGGTTCGGTGTGATCGTG
CGCTGCTACGAACACTGAC: GCTGCTACGAACACTGACA
CATGAGTTAGACTGCGGAA: ATGAGTTAGACTGCGGAAG
GTGCGCTGCTACGAACACT: TGCGCTGCTACGAACACTG
TAGATGGATAGGCAGAACC: AGATGGATAGGCAGAACCT
CGTACGTACGATAAGATCC: GTACGTACGATAAGATCCT
TAAGTCGACCTCCGCTTCC: AAGTCGACCTCCGCTTCCC
ATTATTCACAATGACCTTC: TTATTCACAATGACCTTCA
ACTCACGTGAGCGACTGCG: CTCACGTGAGCGACTGCGT
CCGGGCCTCAACGCTAGGA: CGGGCCTCAACGCTAGGAT
AATGTTTTTAAACCCGTAA: ATGTTTTTAAACCCGTAAA
GTCCGGTGTCACAACGTCC: TCCGGTGTCACAACGTCCC
AAACAGTAACGTAACACAA: AACAGTAACGTAACACAAT
GCGGAAGGGTTTCAGTCCG: CGGAAGGGTTTCAGTCCGG
TACGAATCCAGCGTATTGC: ACGAATCCAGCGTATTGCC
GATCGGATGGCGCGCACTA: ATCGGATGGCGCGCACTAC
AACTGCTCATGCACCTCCA: ACTGCTCATGCACCTCCAC
GGCAAGCACCCTTTGTTAA: GCAAGCACCCTTTGTTAAA
AGTAGACCTTCCACGTTTA: GTAGACCTTCCACGTTTAT
TTGCTCATACGAATCCAGC: TGCTCATACGAATCCAGCG
ACGTACGATAAGATCCTAT: CGTACGATAAGATCCTATG
CCGTTCGCGCCTCTTACCA: CGTTCGCGCCTCTTACCAA
AATCGGACAACACCAACTC: ATCGGACAACACCAACTCA
TTGCCGGTCCAGGAGGTTG: TGCCGGTCCAGGAGGTTGT
CGCGGATGATAACGACAGC: GCGGATGATAACGACAGCC
TTAACACCCAATCTTCCGG: TAACACCCAATCTTCCGGG
CCTAATACTGTGGTCAGAT: CTAATACTGTGGTCAGATC
AAAGGGACATGGGTGCCAA: AAGGGACATGGGTGCCAAG
TTCTAGGGGAGTGTCGCAC: TCTAGGGGAGTGTCGCACC
TGACCTTCATCGCGGATGA: GACCTTCATCGCGGATGAT
CCCTTTGTTAAACACAACC: CCTTTGTTAAACACAACCG
AGCATAATTCAGTGCGTTG: GCATAATTCAGTGCGTTGT
CTAAAGAAGCGAGAAACGC: TAAAGAAGCGAGAAACGCG
TACGAACACTGACAAAGGG: ACGAACACTGACAAAGGGA
AAGCCGGACAGACGAAGCA: AGCCGGACAGACGAAGCAC
GTTGCATGGTAATCGCAGT: TTGCATGGTAATCGCAGTG
CTCATGCACCTCCACCGCT: TCATGCACCTCCACCGCTG
CCCACAATAGATGGATAGG: CCACAATAGATGGATAGGC
TCTAGGGGAGTGTCGCACC: CTAGGGGAGTGTCGCACCT
GATCCTATGCGGATACGAT: ATCCTATGCGGATACGATA
GCGAACGATGTCGCGGAAA: CGAACGATGTCGCGGAAAA
ACACGTACGTTAATTTCAC: CACGTACGTTAATTTCACC
TCTGGTGCGCTAGGGGAGT: CTGGTGCGCTAGGGGAGTG
GCGTATGCATGTGCTCCGA: CGTATGCATGTGCTCCGAG
CATCGGAAATGGTGCATGC: ATCGGAAATGGTGCATGCT
CCAGAGTCTAGTCAGCTCC: CAGAGTCTAGTCAGCTCCA
CCGGTTATAGGGCCCACTT: CGGTTATAGGGCCCACTTT
ACAAGCGTTCGAAGAACAT: CAAGCGTTCGAAGAACATG
GAAGATGCGATGTTAACAG: AAGATGCGATGTTAACAGT
CATCCAGAGTCTAGTCAGC: ATCCAGAGTCTAGTCAGCT
CCGCGTTCTACTGAGTCAT: CGCGTTCTACTGAGTCATA
AGTGCGTTGTCCTCATCGT: GTGCGTTGTCCTCATCGTA
CTTCCCAGGTCTCGTGAGG: TTCCCAGGTCTCGTGAGGC
TGATTACTCGTGAGCGCTC: GATTACTCGTGAGCGCTCG
GATACCCCAAGAATTGAGA: ATACCCCAAGAATTGAGAC
ATCTTCCGGGGGGTTTAGA: TCTTCCGGGGGGTTTAGAT
AGAACATATTTCACGGAAG: GAACATATTTCACGGAAGA
GCGGGTGATTCCATCGGTT: CGGGTGATTCCATCGGTTC
AATCCATCTTGCGATCGGA: ATCCATCTTGCGATCGGAT
CATGGTAATCGCAGTGTCG: ATGGTAATCGCAGTGTCGT
AAGAGTGTAGTCTTTCTTA: AGAGTGTAGTCTTTCTTAG
AACCGACATTAAGCCCATA: ACCGACATTAAGCCCATAC
GCTCCTTGATGTAGGACAG: CTCCTTGATGTAGGACAGG
TAGATAGAAATTGTACACA: AGATAGAAATTGTACACAG
TCGGTGTGATCGTGGAGGG: CGGTGTGATCGTGGAGGGG
TCCGGTAAATACATTAGAA: CCGGTAAATACATTAGAAC
GTCTGGAAATCCTCGCGCA: TCTGGAAATCCTCGCGCAC
TAGAAATTGTACACAGAAA: AGAAATTGTACACAGAAAT
TTATTGCTCCTTGATGTAG: TATTGCTCCTTGATGTAGG
TGAGTGCTTAAGGTTAATG: GAGTGCTTAAGGTTAATGT
TTGGTTGAACCCGCAAGCT: TGGTTGAACCCGCAAGCTG
ATTGTACACAGAAATATGG: TTGTACACAGAAATATGGC
GTCCGGCTTCCGGTTATAG: TCCGGCTTCCGGTTATAGG
ACTCATGTGCATCGGAAAT: CTCATGTGCATCGGAAATG
CTTCCCATGACGTGATTAC: TTCCCATGACGTGATTACT
GCACCCTTTGTTAAACACA: CACCCTTTGTTAAACACAA
GGTTAACAGTAGTTTTGGC: GTTAACAGTAGTTTTGGCG
GTTTTTGTGCTCTAGGTCC: TTTTTGTGCTCTAGGTCCG
TTGTTCCCACGTCGAGCGC: TGTTCCCACGTCGAGCGCG
ATGTCTAAACTGCTCATGC: TGTCTAAACTGCTCATGCA
AAGCCCATACTTCATTTAC: AGCCCATACTTCATTTACG
GTCAAAAGCCCTCAGCGGG: TCAAAAGCCCTCAGCGGGT
TCGTGAGCGCTCGGTGAGA: CGTGAGCGCTCGGTGAGAG
CTGGTGACTATGCTAGTGG: TGGTGACTATGCTAGTGGT
TCCTATGTCACTGACATCC: CCTATGTCACTGACATCCG
ACGGAGATCTGGTGCGCTA: CGGAGATCTGGTGCGCTAG
TGCCAAGACTCGCGATACC: GCCAAGACTCGCGATACCC
GTGTCGCACCTAGTGGGAA: TGTCGCACCTAGTGGGAAC
GGTCTCCTAATACTGTGGT: GTCTCCTAATACTGTGGTC
TCTTAATGCCTCCTAGGGG: CTTAATGCCTCCTAGGGGA
CTCAGCGGGTACCCAGGCA: TCAGCGGGTACCCAGGCAG
CCAGGCAGTAGACCGAGGG: CAGGCAGTAGACCGAGGGG
CAAGCTGAGTGCTTAAGGT: AAGCTGAGTGCTTAAGGTT
AGCCTCTTCGCAAAGAAAA: GCCTCTTCGCAAAGAAAAG
AATGGTGCATGCTCTTAAT: ATGGTGCATGCTCTTAATG
TATACGGGAGCTTGAGTCA: ATACGGGAGCTTGAGTCAA
CATTAGAACATATTTCACG: ATTAGAACATATTTCACGG
CAAAGGGACATGGGTGCCA: AAAGGGACATGGGTGCCAA
GCCCCCTATCCTATGTCAC: CCCCCTATCCTATGTCACT
GTTGTTTTTGTGCTCTAGG: TTGTTTTTGTGCTCTAGGT
CGTTCGAAGAACATGTCTA: GTTCGAAGAACATGTCTAA
AAGAATTGAGACACAACCT: AGAATTGAGACACAACCTA
TTATACGGATCTATCGACG: TATACGGATCTATCGACGA
ATGTCGCGGAAAATCCATC: TGTCGCGGAAAATCCATCT
ACCCTTTACGAAAGAAGCC: CCCTTTACGAAAGAAGCCT
CTCGGGCCCCTCTTAGCGG: TCGGGCCCCTCTTAGCGGT
GTCTAGTCAGCTCCATGTT: TCTAGTCAGCTCCATGTTT
AGAAATATGGCGTAACAAG: GAAATATGGCGTAACAAGC
GGCAGTAGACCGAGGGGAT: GCAGTAGACCGAGGGGATC
GGTTGAATGTTTTTAAACC: GTTGAATGTTTTTAAACCC
GTCGCACCGTCAGAGGCGG: TCGCACCGTCAGAGGCGGA
CCTCAGCGGGTACCCAGGC: CTCAGCGGGTACCCAGGCA
GGGTTAACAGTAGTTTTGG: GGTTAACAGTAGTTTTGGC
TGCTCCTTGATGTAGGACA: GCTCCTTGATGTAGGACAG
GGTGTGATCGTGGAGGGGG: GTGTGATCGTGGAGGGGGC
TACGTTAATTTCACCATGA: ACGTTAATTTCACCATGAG
AAACAGCACAAGAGTGTAG: AACAGCACAAGAGTGTAGT
CTCTTAGCGGTCTGGAAAT: TCTTAGCGGTCTGGAAATC
CAGAAATATGGCGTAACAA: AGAAATATGGCGTAACAAG
GGAAATCCTCGCGCACATT: GAAATCCTCGCGCACATTG
CTAGGATTATTCAATGTAC: TAGGATTATTCAATGTACA
GGAACAAGTCGACCTCCGC: GAACAAGTCGACCTCCGCT
GGTTGTTTTTGTGCTCTAG: GTTGTTTTTGTGCTCTAGG
GCTTGTTAAATAATATAGA: CTTGTTAAATAATATAGAA
CAGTCCGGCTTCCGGTTAT: AGTCCGGCTTCCGGTTATA
GGTTATCGGTCTAGGCTAT: GTTATCGGTCTAGGCTATT
ATGCACCTCCACCGCTGTT: TGCACCTCCACCGCTGTTT
TTCACCACGACCTGAATCC: TCACCACGACCTGAATCCC
AGATAGAAATTGTACACAG: GATAGAAATTGTACACAGA
ACCTTCCACGTTTATACGG: CCTTCCACGTTTATACGGA
TACGGAGATCTGGTGCGCT: ACGGAGATCTGGTGCGCTA
GTCTCATCGAGATGCGATG: TCTCATCGAGATGCGATGA
TTCACGGAAGATGCGATGT: TCACGGAAGATGCGATGTT
GAGTGTCGCACCCCACCGA: AGTGTCGCACCCCACCGAT
ACAGGGGATTGGTTGAACC: CAGGGGATTGGTTGAACCC
CACGTACGTTAATTTCACC: ACGTACGTTAATTTCACCA
AACAAGCGTTCGAAGAACA: ACAAGCGTTCGAAGAACAT
GCAAGCTGAGTGCTTAAGG: CAAGCTGAGTGCTTAAGGT
AGCGACTGCGTAGACAGTC: GCGACTGCGTAGACAGTCG
TTACACACGTACGTTAATT: TACACACGTACGTTAATTT
GATTACTCGTGAGCGCTCG: ATTACTCGTGAGCGCTCGG
AAGGTTAATGTCGAAACCC: AGGTTAATGTCGAAACCCT
CCTACCAGGCTGCTTGTTA: CTACCAGGCTGCTTGTTAA
CCATGTTTTGCTCATACGA: CATGTTTTGCTCATACGAA
GGTAATCGCAGTGTCGTCC: GTAATCGCAGTGTCGTCCT
CGCTTGGCGTATTAGTCCC: GCTTGGCGTATTAGTCCCC
GCTTCCCATGTGCGCTGCT: CTTCCCATGTGCGCTGCTA
CCGCTTCCCAGGTGGCTCT: CGCTTCCCAGGTGGCTCTT
TTTACGGAGATCTGGTGCG: TTACGGAGATCTGGTGCGC
TCCTAATACTGTGGTCAGA: CCTAATACTGTGGTCAGAT
GTGGCTCTTTACTTAGTTT: TGGCTCTTTACTTAGTTTG
ACGGAAGATGCGATGTTAA: CGGAAGATGCGATGTTAAC
AGATATCTTCACCACGACC: GATATCTTCACCACGACCT
GTAACAAGCGTTCGAAGAA: TAACAAGCGTTCGAAGAAC
CTCATCGTAATTAACACCC: TCATCGTAATTAACACCCA
CCTTGTGAATGGGTTAACA: CTTGTGAATGGGTTAACAG
CTGGAAATCCTCGCGCACA: TGGAAATCCTCGCGCACAT
CGACGAGGAAGGCGCCCAA: GACGAGGAAGGCGCCCAAG
TGAGACACAACCTAAAGAA: GAGACACAACCTAAAGAAG
TAGTGGTACCCTTGTGAAT: AGTGGTACCCTTGTGAATG
CATGCTCTTAATGCCTCCT: ATGCTCTTAATGCCTCCTA
TGAGCGACTGCGTAGACAG: GAGCGACTGCGTAGACAGT
CCCCGTACGTACGATAAGA: CCCGTACGTACGATAAGAT
ATTCACCAATGCACCTGGT: TTCACCAATGCACCTGGTG
GTCACTGACATCCGTGTTG: TCACTGACATCCGTGTTGC
TAATACTGTGGTCAGATCC: AATACTGTGGTCAGATCCA
ATCCTCGCGCACATTGCGA: TCCTCGCGCACATTGCGAC
ATAGATGGATAGGCAGAAC: TAGATGGATAGGCAGAACC
CAGTAGACCGAGGGGATCG: AGTAGACCGAGGGGATCGT
TGAATGTTTTTAAACCCGT: GAATGTTTTTAAACCCGTA
GTAGTTTTGGCGGGTGATT: TAGTTTTGGCGGGTGATTC
GAGCATAATTCAGTGCGTT: AGCATAATTCAGTGCGTTG
AGGGGATTGGTTGAACCCG: GGGGATTGGTTGAACCCGC
TCTAAACTGCTCATGCACC: CTAAACTGCTCATGCACCT
TGTCTAAACTGCTCATGCA: GTCTAAACTGCTCATGCAC
GTGCATCGGAAATGGTGCA: TGCATCGGAAATGGTGCAT
CACCCAATCTTCCGGGGGG: ACCCAATCTTCCGGGGGGT
CTAGGGGAGTGTCGCACCT: TAGGGGAGTGTCGCACCTA
TCCTATGCGGATACGATAT: CCTATGCGGATACGATATT
GCCTCTTCGCAAAGAAAAG: CCTCTTCGCAAAGAAAAGT
CACCGGGCCTAATCGCGTA: ACCGGGCCTAATCGCGTAA
GATGAGAGTGGTTTGAATT: ATGAGAGTGGTTTGAATTT
CCCGCGTTCTACTGAGTCA: CCGCGTTCTACTGAGTCAT
GTCCCATCTCGGGCCCCTC: TCCCATCTCGGGCCCCTCT
TCCCAGGTGGCTCTTTACT: CCCAGGTGGCTCTTTACTT
CACGCTTGGCGTATTAGTC: ACGCTTGGCGTATTAGTCC
TTACAGCAGTAAGTTCTTG: TACAGCAGTAAGTTCTTGC
CAGGGGGAGTCATCCAGAG: AGGGGGAGTCATCCAGAGT
GGGGGGTTTAGATAGAAAT: GGGGGTTTAGATAGAAATT
GCGGGTACCCAGGCAGTAG: CGGGTACCCAGGCAGTAGA
CCATATCTGGCTTCATTGC: CATATCTGGCTTCATTGCT
AGAGGCGGAGTCGACCTCC: GAGGCGGAGTCGACCTCCG
AGACCGAGGGGATCGTTAT: GACCGAGGGGATCGTTATC
TTAATGTCGAAACCCTGCT: TAATGTCGAAACCCTGCTG
GAGTCGACCTCCGCTTCCC: AGTCGACCTCCGCTTCCCA AGTCGACCTCCGCTTCCCA
GGAAAATCCATCTTGCGAT: GAAAATCCATCTTGCGATC
CGCGATACCCCAAGAATTG: GCGATACCCCAAGAATTGA
CCTAAAGAAGCGAGAAACG: CTAAAGAAGCGAGAAACGC
GTCACAACGTCCCATCTCG: TCACAACGTCCCATCTCGG
CAACGTCCCATCTCGGGCC: AACGTCCCATCTCGGGCCC
TTGCTCAGGACTTGTTCCC: TGCTCAGGACTTGTTCCCA
AACGTAACACAATCCGCAG: ACGTAACACAATCCGCAGC
GGATTGGTTGAACCCGCAA: GATTGGTTGAACCCGCAAG
CTGCTACGAACACTGACAA: TGCTACGAACACTGACAAA
AAAGAAAAGTAGACCTTCC: AAGAAAAGTAGACCTTCCA
ACAGTCGACTACAAGAAGG: CAGTCGACTACAAGAAGGG
CGTTGTCCTCATCGTAATT: GTTGTCCTCATCGTAATTA
GTTAATGTCGAAACCCTGC: TTAATGTCGAAACCCTGCT
AGTCCCCGCGTTCTACTGA: GTCCCCGCGTTCTACTGAG
GCACACCGGGCCTAATCGC: CACACCGGGCCTAATCGCG
ACGACCTGAATCCCTCATC: CGACCTGAATCCCTCATCA
ACCTGGTGACTATGCTAGT: CCTGGTGACTATGCTAGTG
GGACCACTCATGTGCATCG: GACCACTCATGTGCATCGG
TAATGCCTCCTAGGGGAGT: AATGCCTCCTAGGGGAGTG
GCCCGGCTATACGGGAGCT: CCCGGCTATACGGGAGCTT
GTAGACAGTCGACTACAAG: TAGACAGTCGACTACAAGA
AAACCCTGCTGGCGCCTAC: AACCCTGCTGGCGCCTACC
CCGGAATCGGACAACACCA: CGGAATCGGACAACACCAA
GAACAAGTCGACCTCCGCT: AACAAGTCGACCTCCGCTT
CGGAAGATGCGATGTTAAC: GGAAGATGCGATGTTAACA
CAAGCACCCTTTGTTAAAC: AAGCACCCTTTGTTAAACA
GCTGAGTGCTTAAGGTTAA: CTGAGTGCTTAAGGTTAAT
CTAGGGGAGTGTCGCACCA: TAGGGGAGTGTCGCACCAC
GCTTGGCGTATTAGTCCCC: CTTGGCGTATTAGTCCCCG
CAGTAACGTAACACAATCC: AGTAACGTAACACAATCCG
GGTTAATGTCGAAACCCTG: GTTAATGTCGAAACCCTGC
TAGGGGAGTGTCGCACCTA: AGGGGAGTGTCGCACCTAG
GACCTCCGCTTCCCATGTG: ACCTCCGCTTCCCATGTGC
ACGCTAGGATTATTCAATG: CGCTAGGATTATTCAATGT
GTACCTAATGGTCTCACTG: TACCTAATGGTCTCACTGA
ATGGCGTAACAAGCGTTCG: TGGCGTAACAAGCGTTCGA
CGCACTACACAACGTAACG: GCACTACACAACGTAACGC
ACTGCGGAAGGGTTTCAGT: CTGCGGAAGGGTTTCAGTC
TGGCGAGTCGACCTCCGCT: GGCGAGTCGACCTCCGCTT
GTGCATGCTCTTAATGCCT: TGCATGCTCTTAATGCCTC
CGTCCTGCGAGCAATGGTT: GTCCTGCGAGCAATGGTTA
GACCTCCGCTTCCCAGGTG: ACCTCCGCTTCCCAGGTGG
ACATGGGTGCCAAGACTCG: CATGGGTGCCAAGACTCGC
ATAGAAGGCCCCCTATCCT: TAGAAGGCCCCCTATCCTA
TGACGGTTCGGTGTGATCG: GACGGTTCGGTGTGATCGT
TCTCATCGAGATGCGATGA: CTCATCGAGATGCGATGAG
CCACGTCGAGCGCGAACGA: CACGTCGAGCGCGAACGAT
CTTAGTTTGACTAGGGGAG: TTAGTTTGACTAGGGGAGT
TAAACACAACCGACATTAA: AAACACAACCGACATTAAG
AATTTTTACACACGTACGT: ATTTTTACACACGTACGTT
CGTGATTACTCGTGAGCGC: GTGATTACTCGTGAGCGCT
AGGGGAGTGTCGCACCCCA: GGGGAGTGTCGCACCCCAC
GGGGAGTGTCGCACCACTG: GGGAGTGTCGCACCACTGG
GTTTATACGGATCTATCGA: TTTATACGGATCTATCGAC
AAGCGTTCGAAGAACATGT: AGCGTTCGAAGAACATGTC
CTCGCGCACATTGCGACGT: TCGCGCACATTGCGACGTA
TCGCGCCTCTTACCAAATC: CGCGCCTCTTACCAAATCA
CGCCCAGACTGAAACAGCA: GCCCAGACTGAAACAGCAC
TAGCGGTCTGGAAATCCTC: AGCGGTCTGGAAATCCTCG
CAATGCACCTGGTGACTAT: AATGCACCTGGTGACTATG
TGAGTTAGACTGCGGAAGG: GAGTTAGACTGCGGAAGGG
TATCCATATCTGGCTTCAT: ATCCATATCTGGCTTCATT
GGCTAGCCGTATCCATATC: GCTAGCCGTATCCATATCT
GTCTAAACTGCTCATGCAC: TCTAAACTGCTCATGCACC
GAATCGGACAACACCAACT: AATCGGACAACACCAACTC
ACTGCTCATGCACCTCCAC: CTGCTCATGCACCTCCACC
GGGAGTGTCGCACCCCACC: GGAGTGTCGCACCCCACCG
CAAGCCGGACAGACGAAGC: AAGCCGGACAGACGAAGCA
ACATATTTCACGGAAGATG: CATATTTCACGGAAGATGC
ATTCACAATGACCTTCATC: TTCACAATGACCTTCATCG
CACCATGAGTTAGACTGCG: ACCATGAGTTAGACTGCGG
GGTTTTGCTGTACCTAATG: GTTTTGCTGTACCTAATGG
ACACCGGGCCTAATCGCGT: CACCGGGCCTAATCGCGTA
GATTATTCAATGTACAGGG: ATTATTCAATGTACAGGGG
TGGGTGCCAAGACTCGCGA: GGGTGCCAAGACTCGCGAT
TGCGAGCAATGGTTATCGG: GCGAGCAATGGTTATCGGT
GAAATGGTGCATGCTCTTA: AAATGGTGCATGCTCTTAA
CCGGGCCTAATCGCGTAAG: CGGGCCTAATCGCGTAAGA
GCAGTAAGTTCTTGCTGAC: CAGTAAGTTCTTGCTGACG
CCTCTTAGCGGTCTGGAAA: CTCTTAGCGGTCTGGAAAT
TAAACTGCTCATGCACCTC: AAACTGCTCATGCACCTCC
CTCAACGCTAGGATTATTC: TCAACGCTAGGATTATTCA
TGTAGGACAGGGGATTGGT: GTAGGACAGGGGATTGGTT
GTAACGTAACACAATCCGC: TAACGTAACACAATCCGCA
ATCCAGAGTCTAGTCAGCT: TCCAGAGTCTAGTCAGCTC
CGACGTACTAGTCTCATCG: GACGTACTAGTCTCATCGA
TCACAATGACCTTCATCGC: CACAATGACCTTCATCGCG
TCGACCTCCGCTTCCCAGG: CGACCTCCGCTTCCCAGGT CGACCTCCGCTTCCCAGGT
ATCAGGCAAGCACCCTTTG: TCAGGCAAGCACCCTTTGT
AGGCAGAACCTTAGGGTTT: GGCAGAACCTTAGGGTTTT
AGCCGGACAGACGAAGCAC: GCCGGACAGACGAAGCACG
AATACGAGCATAATTCAGT: ATACGAGCATAATTCAGTG
GCTCATACGAATCCAGCGT: CTCATACGAATCCAGCGTA
CATTGCTCAGGACTTGTTC: ATTGCTCAGGACTTGTTCC
GAAATATGGCGTAACAAGC: AAATATGGCGTAACAAGCG
GACAGCCCGGCTATACGGG: ACAGCCCGGCTATACGGGA
ACACAGAAATATGGCGTAA: CACAGAAATATGGCGTAAC
TTGAGTCAAAAGCCCTCAG: TGAGTCAAAAGCCCTCAGC
GGGCCCACTTTAATACGAG: GGCCCACTTTAATACGAGC
CATAAGAGTAAGCTGCCGG: ATAAGAGTAAGCTGCCGGA
TAATATAGAAGGCCCCCTA: AATATAGAAGGCCCCCTAT
CGGTGAGAGCCCACAATAG: GGTGAGAGCCCACAATAGA
CAACGCTAGGATTATTCAA: AACGCTAGGATTATTCAAT
ACAATGACCTTCATCGCGG: CAATGACCTTCATCGCGGA
GCATGTGCTCCGAGCTCAG: CATGTGCTCCGAGCTCAGC
TACTGTGGTCAGATCCACG: ACTGTGGTCAGATCCACGC
AGTGGTACCCTTGTGAATG: GTGGTACCCTTGTGAATGG
ACACCCAATCTTCCGGGGG: CACCCAATCTTCCGGGGGG
GGTTTAGATAGAAATTGTA: GTTTAGATAGAAATTGTAC
CTACTAGATTATTCACAAT: TACTAGATTATTCACAATG
TACCAAATCAGGCAAGCAC: ACCAAATCAGGCAAGCACC
GCAAAGAAAAGTAGACCTT: CAAAGAAAAGTAGACCTTC
GTACGTACGATAAGATCCT: TACGTACGATAAGATCCTA
CGCGTTCTACTGAGTCATA: GCGTTCTACTGAGTCATAA
AACACAATCCGCAGCTGTT: ACACAATCCGCAGCTGTTG
CCGTACGTACGATAAGATC: CGTACGTACGATAAGATCC
ACGAATCCAGCGTATTGCC: CGAATCCAGCGTATTGCCC
GTGGAGGGGGCTCGCCATT: TGGAGGGGGCTCGCCATTG
GGGCTAGCCGTATCCATAT: GGCTAGCCGTATCCATATC
GTAAGCTGCCGGAATCGGA: TAAGCTGCCGGAATCGGAC
CAATGACCTTCATCGCGGA: AATGACCTTCATCGCGGAT
TTATCTACGACTAGTTACG: TATCTACGACTAGTTACGG
GGGGCTCGCCATTGCTCAG: GGGCTCGCCATTGCTCAGG
GGGACCACTCATGTGCATC: GGACCACTCATGTGCATCG
GATGCGATGAGAGTGGTTT: ATGCGATGAGAGTGGTTTG
GATGTAGGACAGGGGATTG: ATGTAGGACAGGGGATTGG
AGTTAGACTGCGGAAGGGT: GTTAGACTGCGGAAGGGTT
TCTATCGACGAGGAAGGCG: CTATCGACGAGGAAGGCGC
TGAGAGCCCACAATAGATG: GAGAGCCCACAATAGATGG
TGTCGCGGAAAATCCATCT: GTCGCGGAAAATCCATCTT
CTGCGTAGACAGTCGACTA: TGCGTAGACAGTCGACTAC
AACGTCCCATCTCGGGCCC: ACGTCCCATCTCGGGCCCC
ACCTAATGGTCTCACTGAC: CCTAATGGTCTCACTGACG
TCTTGCTGACGCACACCGG: CTTGCTGACGCACACCGGG
ACTGAGTCATAAGAGTAAG: CTGAGTCATAAGAGTAAGC
CGCAGCTGTTGCATGGTAA: GCAGCTGTTGCATGGTAAT
GGACAACACCAACTCACGT: GACAACACCAACTCACGTG
CTGCCGGAATCGGACAACA: TGCCGGAATCGGACAACAC
ATTTTATTGCTCCTTGATG: TTTTATTGCTCCTTGATGT
GCTCTAGGTCCGGTGTCAC: CTCTAGGTCCGGTGTCACA
TTGTGCTCTAGGTCCGGTG: TGTGCTCTAGGTCCGGTGT
GGGGATTGGTTGAACCCGC: GGGATTGGTTGAACCCGCA
TTAGCGGTCTGGAAATCCT: TAGCGGTCTGGAAATCCTC
CGAGCTCAGCCGGCCTATA: GAGCTCAGCCGGCCTATAA
TGAGGCATGACCCTTTACG: GAGGCATGACCCTTTACGA
ACGTTTATACGGATCTATC: CGTTTATACGGATCTATCG
ATGTGCTCCGAGCTCAGCC: TGTGCTCCGAGCTCAGCCG
ACACAACGTAACGCCTTTA: CACAACGTAACGCCTTTAC
ATCGTTATCTACGACTAGT: TCGTTATCTACGACTAGTT
ACGTGAGCGACTGCGTAGA: CGTGAGCGACTGCGTAGAC
TGAGAGTGGTTTGAATTTT: GAGAGTGGTTTGAATTTTT
CGACCTCCGCTTCCCATGA: GACCTCCGCTTCCCATGAC
GTGTTGCCGGTCCAGGAGG: TGTTGCCGGTCCAGGAGGT
GCCAAGACTCGCGATACCC: CCAAGACTCGCGATACCCC
CACCACTGGTTGGCGAGTC: ACCACTGGTTGGCGAGTCG
GATGGATAGGCAGAACCTT: ATGGATAGGCAGAACCTTA
AGTCTTTCTTAGGATCAAA: GTCTTTCTTAGGATCAAAC
CATCGAGATGCGATGAGAG: ATCGAGATGCGATGAGAGT
TAGGGGAGTGTCGCACCAC: AGGGGAGTGTCGCACCACT
CATGTGCGCTGCTACGAAC: ATGTGCGCTGCTACGAACA
CGCACCTAGTGGGAACAAG: GCACCTAGTGGGAACAAGT
TTAGAACATATTTCACGGA: TAGAACATATTTCACGGAA
TGTCGCACCTAGTGGGAAC: GTCGCACCTAGTGGGAACA
GGCATGACCCTTTACGAAA: GCATGACCCTTTACGAAAG
CTTCGCAAAGAAAAGTAGA: TTCGCAAAGAAAAGTAGAC
TGTGAATGGGTTAACAGTA: GTGAATGGGTTAACAGTAG
AGTTCTTGCTGACGCACAC: GTTCTTGCTGACGCACACC
GAGCGCTCGGTGAGAGCCC: AGCGCTCGGTGAGAGCCCA
ATACCCCAAGAATTGAGAC: TACCCCAAGAATTGAGACA
TTAGGGTTTTGCTGTACCT: TAGGGTTTTGCTGTACCTA
AACGTAACGCCTTTACAGC: ACGTAACGCCTTTACAGCA
CGTGTTGCCGGTCCAGGAG: GTGTTGCCGGTCCAGGAGG
CCACAATAGATGGATAGGC: CACAATAGATGGATAGGCA
CTCCGCTTCCCATGACGTG: TCCGCTTCCCATGACGTGA
TTGCGACGTACTAGTCTCA: TGCGACGTACTAGTCTCAT
GAGTTAGACTGCGGAAGGG: AGTTAGACTGCGGAAGGGT
ATGTCACTGACATCCGTGT: TGTCACTGACATCCGTGTT
ACCCCACCGATTTAAGTCG: CCCCACCGATTTAAGTCGA
CAAGAAGGGTGCTCTAGAT: AAGAAGGGTGCTCTAGATA
GAGCGCGAACGATGTCGCG: AGCGCGAACGATGTCGCGG
AGCGGGTACCCAGGCAGTA: GCGGGTACCCAGGCAGTAG
CGTTCTACTGAGTCATAAG: GTTCTACTGAGTCATAAGA
CGCGTAAGATACCGGGCCT: GCGTAAGATACCGGGCCTC
GAGATGCGATGAGAGTGGT: AGATGCGATGAGAGTGGTT
TATGCGGATACGATATTCA: ATGCGGATACGATATTCAC
ACTGACATCCGTGTTGCCG: CTGACATCCGTGTTGCCGG
TACCCGCTCAGGATCCACA: ACCCGCTCAGGATCCACAA
GCTCGCCATTGCTCAGGAC: CTCGCCATTGCTCAGGACT
TTGTTAAACACAACCGACA: TGTTAAACACAACCGACAT
GAGCAATGGTTATCGGTCT: AGCAATGGTTATCGGTCTA
CGCTAGGGGAGTGTCGCAC: GCTAGGGGAGTGTCGCACC
CTTCATTGCTAACGCGGGA: TTCATTGCTAACGCGGGAT
ATTGCTCAGGACTTGTTCC: TTGCTCAGGACTTGTTCCC
GTCATAAGAGTAAGCTGCC: TCATAAGAGTAAGCTGCCG
TGCTCAGGACTTGTTCCCA: GCTCAGGACTTGTTCCCAC
ATAAGAGTAAGCTGCCGGA: TAAGAGTAAGCTGCCGGAA
TCATCGTAATTAACACCCA: CATCGTAATTAACACCCAA
ATGGGTGCCAAGACTCGCG: TGGGTGCCAAGACTCGCGA
AGCCCGGCTATACGGGAGC: GCCCGGCTATACGGGAGCT
GGCGCGCACTACACAACGT: GCGCGCACTACACAACGTA
TTCACCAATGCACCTGGTG: TCACCAATGCACCTGGTGA
GGGATTGGTTGAACCCGCA: GGATTGGTTGAACCCGCAA
GGTGACTATGCTAGTGGTA: GTGACTATGCTAGTGGTAC
CAAGAGTGTAGTCTTTCTT: AAGAGTGTAGTCTTTCTTA
CAGTGCGTTGTCCTCATCG: AGTGCGTTGTCCTCATCGT
CGGAAAATCCATCTTGCGA: GGAAAATCCATCTTGCGAT
GTCGAAACCCTGCTGGCGC: TCGAAACCCTGCTGGCGCC
CTTTACTTAGTTTGACTAG: TTTACTTAGTTTGACTAGG
GGGTACCCAGGCAGTAGAC: GGTACCCAGGCAGTAGACC
TATTTTATTGCTCCTTGAT: ATTTTATTGCTCCTTGATG
ATGTTAACAGTGGTCACAC: TGTTAACAGTGGTCACACG
TATACCCGCTCAGGATCCA: ATACCCGCTCAGGATCCAC
CTCTTTACTTAGTTTGACT: TCTTTACTTAGTTTGACTA
AGCACAAGAGTGTAGTCTT: GCACAAGAGTGTAGTCTTT
AATAATATAGAAGGCCCCC: ATAATATAGAAGGCCCCCT
GCTCATGCACCTCCACCGC: CTCATGCACCTCCACCGCT
GCACCCCACCGATTTAAGT: CACCCCACCGATTTAAGTC
GTTATAGGGCCCACTTTAA: TTATAGGGCCCACTTTAAT
CCGGTAAATACATTAGAAC: CGGTAAATACATTAGAACA
TTAAATAATATAGAAGGCC: TAAATAATATAGAAGGCCC
ACGACAGCCCGGCTATACG: CGACAGCCCGGCTATACGG
CCCGGGGTTCATCTACTAG: CCGGGGTTCATCTACTAGA
GGTCCGGTGTCACAACGTC: GTCCGGTGTCACAACGTCC
ACGCTTGGCGTATTAGTCC: CGCTTGGCGTATTAGTCCC
CATCTACTAGATTATTCAC: ATCTACTAGATTATTCACA
GCGCCTACCAGGCTGCTTG: CGCCTACCAGGCTGCTTGT
CTTGATGTAGGACAGGGGA: TTGATGTAGGACAGGGGAT
TTTGCTCATACGAATCCAG: TTGCTCATACGAATCCAGC
GCGCTCGGTGAGAGCCCAC: CGCTCGGTGAGAGCCCACA
CTCGTGAGGCATGACCCTT: TCGTGAGGCATGACCCTTT
CCGCTTCCCAGGTCTCGTG: CGCTTCCCAGGTCTCGTGA
AGGTCTCCTAATACTGTGG: GGTCTCCTAATACTGTGGT
ATGGTTATCGGTCTAGGCT: TGGTTATCGGTCTAGGCTA
ACTCGCGATACCCCAAGAA: CTCGCGATACCCCAAGAAT
TCACCAATGCACCTGGTGA: CACCAATGCACCTGGTGAC
AAGAAGCCTCTTCGCAAAG: AGAAGCCTCTTCGCAAAGA
ATCGGACAACACCAACTCA: TCGGACAACACCAACTCAC
TCCTCATCGTAATTAACAC: CCTCATCGTAATTAACACC
CGATGAGAGTGGTTTGAAT: GATGAGAGTGGTTTGAATT
AGTTTGACTAGGGGAGTGT: GTTTGACTAGGGGAGTGTC
GCGTTCGAAGAACATGTCT: CGTTCGAAGAACATGTCTA
GAACACTGACAAAGGGACA: AACACTGACAAAGGGACAT
GTCGTCCTGCGAGCAATGG: TCGTCCTGCGAGCAATGGT
CGCAAGCTGAGTGCTTAAG: GCAAGCTGAGTGCTTAAGG
AGGAGGTTGTTTTTGTGCT: GGAGGTTGTTTTTGTGCTC
AAAATCCATCTTGCGATCG: AAATCCATCTTGCGATCGG
AACACCCAATCTTCCGGGG: ACACCCAATCTTCCGGGGG
TCAACGCTAGGATTATTCA: CAACGCTAGGATTATTCAA
AGCAGTAAGTTCTTGCTGA: GCAGTAAGTTCTTGCTGAC
CGACATTAAGCCCATACTT: GACATTAAGCCCATACTTC
GCGATGAGAGTGGTTTGAA: CGATGAGAGTGGTTTGAAT
ACCTTCATCGCGGATGATA: CCTTCATCGCGGATGATAA
ACATCCGTGTTGCCGGTCC: CATCCGTGTTGCCGGTCCA
GTTAATTTCACCATGAGTT: TTAATTTCACCATGAGTTA
ATCGGATGGCGCGCACTAC: TCGGATGGCGCGCACTACA
CTTTGTTAAACACAACCGA: TTTGTTAAACACAACCGAC
CCTTCCACGTTTATACGGA: CTTCCACGTTTATACGGAT
CAGCAGTAAGTTCTTGCTG: AGCAGTAAGTTCTTGCTGA
CGAAGAACATGTCTAAACT: GAAGAACATGTCTAAACTG
CGTAATTAACACCCAATCT: GTAATTAACACCCAATCTT
TAAGCCCATACTTCATTTA: AAGCCCATACTTCATTTAC
AGTGTCGCACCTAGTGGGA: GTGTCGCACCTAGTGGGAA
CCCAAGCCGGACAGACGAA: CCAAGCCGGACAGACGAAG
ATCGGAAATGGTGCATGCT: TCGGAAATGGTGCATGCTC
ACAATCCGCAGCTGTTGCA: CAATCCGCAGCTGTTGCAT
GGGGTTCATCTACTAGATT: GGGTTCATCTACTAGATTA
GATGCGATGTTAACAGTGG: ATGCGATGTTAACAGTGGT
AATACATTAGAACATATTT: ATACATTAGAACATATTTC
GAGTGTCGCACCTAGTGGG: AGTGTCGCACCTAGTGGGA
CCCGCTCAGGATCCACAAG: CCGCTCAGGATCCACAAGC
TACGAGCATAATTCAGTGC: ACGAGCATAATTCAGTGCG
GACTGCGTAGACAGTCGAC: ACTGCGTAGACAGTCGACT
ATACTTCATTTACGGAGAT: TACTTCATTTACGGAGATC
ACGCGGGATCTTCTAGGGG: CGCGGGATCTTCTAGGGGA
AGTCTAGTCAGCTCCATGT: GTCTAGTCAGCTCCATGTT
CGTCGAGCGCGAACGATGT: GTCGAGCGCGAACGATGTC
CGTGAGCGACTGCGTAGAC: GTGAGCGACTGCGTAGACA
CCACTTTAATACGAGCATA: CACTTTAATACGAGCATAA
CGCGCACATTGCGACGTAC: GCGCACATTGCGACGTACT
TTCCGGTAAATACATTAGA: TCCGGTAAATACATTAGAA
GAGAAACGCGTATGCATGT: AGAAACGCGTATGCATGTG
TGATGTAGGACAGGGGATT: GATGTAGGACAGGGGATTG
CATACGAATCCAGCGTATT: ATACGAATCCAGCGTATTG
AGGGGAGTGTCGCACCACT: GGGGAGTGTCGCACCACTG
TCATCGCGGATGATAACGA: CATCGCGGATGATAACGAC
GACCTGAATCCCTCATCAG: ACCTGAATCCCTCATCAGC
GACGAAGCACGTATACCCG: ACGAAGCACGTATACCCGC
GCCTCCTAGGGGAGTGTCG: CCTCCTAGGGGAGTGTCGC
CTGTTTGGGCTAGCCGTAT: TGTTTGGGCTAGCCGTATC
CTAGGGGAGTGTCGCACCC: TAGGGGAGTGTCGCACCCC
TACCAGGCTGCTTGTTAAA: ACCAGGCTGCTTGTTAAAT
CTGGTTGGCGAGTCGACCT: TGGTTGGCGAGTCGACCTC
ACTGAAACAGCACAAGAGT: CTGAAACAGCACAAGAGTG
TAGAAGGCCCCCTATCCTA: AGAAGGCCCCCTATCCTAT
ACGTACTAGTCTCATCGAG: CGTACTAGTCTCATCGAGA
AATACTGTGGTCAGATCCA: ATACTGTGGTCAGATCCAC
ACAGTAGTTTTGGCGGGTG: CAGTAGTTTTGGCGGGTGA
GGAAGGCGCCCAAGCCGGA: GAAGGCGCCCAAGCCGGAC
CTTGTGAATGGGTTAACAG: TTGTGAATGGGTTAACAGT
TCGACGAGGAAGGCGCCCA: CGACGAGGAAGGCGCCCAA
TGCTCTAGATATCTTCACC: GCTCTAGATATCTTCACCA
ACGAGGAAGGCGCCCAAGC: CGAGGAAGGCGCCCAAGCC
AACGCCTTTACAGCAGTAA: ACGCCTTTACAGCAGTAAG
GAGGGGATCGTTATCTACG: AGGGGATCGTTATCTACGA
AGTTTTGGCGGGTGATTCC: GTTTTGGCGGGTGATTCCA
TAACAGTAGTTTTGGCGGG: AACAGTAGTTTTGGCGGGT
GAACCCGCAAGCTGAGTGC: AACCCGCAAGCTGAGTGCT
ACCTCCGCTTCCCAGGTGG: CCTCCGCTTCCCAGGTGGC
TTGCTCCTTGATGTAGGAC: TGCTCCTTGATGTAGGACA
AAGTAGGGGACCACTCATG: AGTAGGGGACCACTCATGT
ACGATGTCGCGGAAAATCC: CGATGTCGCGGAAAATCCA
CCAAGAATTGAGACACAAC: CAAGAATTGAGACACAACC
GATAACGACAGCCCGGCTA: ATAACGACAGCCCGGCTAT
TGTTAACAGTGGTCACACG: GTTAACAGTGGTCACACGC
AAGGCGCCCAAGCCGGACA: AGGCGCCCAAGCCGGACAG
TTTAAACCCGTAAAAGTAG: TTAAACCCGTAAAAGTAGG
CGAGGAAGGCGCCCAAGCC: GAGGAAGGCGCCCAAGCCG
CTAGATATCTTCACCACGA: TAGATATCTTCACCACGAC
CAAGACTCGCGATACCCCA: AAGACTCGCGATACCCCAA
TTGTTTTTGTGCTCTAGGT: TGTTTTTGTGCTCTAGGTC
GCCGGACAGACGAAGCACG: CCGGACAGACGAAGCACGT
TAAGATACCGGGCCTCAAC: AAGATACCGGGCCTCAACG
TAGTGGGAACAAGTCGACC: AGTGGGAACAAGTCGACCT
AGCCCGGGGTTCATCTACT: GCCCGGGGTTCATCTACTA
TGCTCTTAATGCCTCCTAG: GCTCTTAATGCCTCCTAGG
GGTTCGGTGTGATCGTGGA: GTTCGGTGTGATCGTGGAG
AGCGCTCGGTGAGAGCCCA: GCGCTCGGTGAGAGCCCAC
AGAAGCCTCTTCGCAAAGA: GAAGCCTCTTCGCAAAGAA
GCTGCTTGTTAAATAATAT: CTGCTTGTTAAATAATATA
TAGGCAGAACCTTAGGGTT: AGGCAGAACCTTAGGGTTT
CGAGCGCGAACGATGTCGC: GAGCGCGAACGATGTCGCG
GATGATAACGACAGCCCGG: ATGATAACGACAGCCCGGC
CCATCTTGCGATCGGATGG: CATCTTGCGATCGGATGGC
CCTTTACAGCAGTAAGTTC: CTTTACAGCAGTAAGTTCT
GTCCCCGCGTTCTACTGAG: TCCCCGCGTTCTACTGAGT
GTCAGATCCACGCCCAGAC: TCAGATCCACGCCCAGACT
CCTCAACGCTAGGATTATT: CTCAACGCTAGGATTATTC
CCACGCCCAGACTGAAACA: CACGCCCAGACTGAAACAG
ACGTATACCCGCTCAGGAT: CGTATACCCGCTCAGGATC
GGCCTAATCGCGTAAGATA: GCCTAATCGCGTAAGATAC
CATATTTCACGGAAGATGC: ATATTTCACGGAAGATGCG
AGACAGTCGACTACAAGAA: GACAGTCGACTACAAGAAG
ACTACACAACGTAACGCCT: CTACACAACGTAACGCCTT
GGGAACAAGTCGACCTCCG: GGAACAAGTCGACCTCCGC
AGCTCAGCCGGCCTATAAG: GCTCAGCCGGCCTATAAGG
AGTGTCGTCCTGCGAGCAA: GTGTCGTCCTGCGAGCAAT
ACGCCCAGACTGAAACAGC: CGCCCAGACTGAAACAGCA
CGAGCAATGGTTATCGGTC: GAGCAATGGTTATCGGTCT
CGCTTCCCATGACGTGATT: GCTTCCCATGACGTGATTA
CGGGCCTCAACGCTAGGAT: GGGCCTCAACGCTAGGATT
CTATCCTATGTCACTGACA: TATCCTATGTCACTGACAT
TCGCACCGTCAGAGGCGGA: CGCACCGTCAGAGGCGGAG
ATATAGAAGGCCCCCTATC: TATAGAAGGCCCCCTATCC
AACAGCACAAGAGTGTAGT: ACAGCACAAGAGTGTAGTC
TCAGTCCGGCTTCCGGTTA: CAGTCCGGCTTCCGGTTAT
TACCCTTGTGAATGGGTTA: ACCCTTGTGAATGGGTTAA
TCCCTCATCAGCCGTTCGC: CCCTCATCAGCCGTTCGCG
CAGGACTTGTTCCCACGTC: AGGACTTGTTCCCACGTCG
AGGCTATTTTATTGCTCCT: GGCTATTTTATTGCTCCTT
TCTAGGCTATTTTATTGCT: CTAGGCTATTTTATTGCTC
ACCTGAATCCCTCATCAGC: CCTGAATCCCTCATCAGCC
TCAGCCGTTCGCGCCTCTT: CAGCCGTTCGCGCCTCTTA
CGTAACACAATCCGCAGCT: GTAACACAATCCGCAGCTG
CTCGTGAGCGCTCGGTGAG: TCGTGAGCGCTCGGTGAGA
AGGGGGCTCGCCATTGCTC: GGGGGCTCGCCATTGCTCA
GCTCAGGACTTGTTCCCAC: CTCAGGACTTGTTCCCACG
GATTGGTTGAACCCGCAAG: ATTGGTTGAACCCGCAAGC
GTGCGTTGTCCTCATCGTA: TGCGTTGTCCTCATCGTAA
CTAACGCGGGATCTTCTAG: TAACGCGGGATCTTCTAGG
CATCAGCCGTTCGCGCCTC: ATCAGCCGTTCGCGCCTCT
GCGAGAAACGCGTATGCAT: CGAGAAACGCGTATGCATG
GCTTGAGTCAAAAGCCCTC: CTTGAGTCAAAAGCCCTCA
TTGTACACAGAAATATGGC: TGTACACAGAAATATGGCG
TGTCGCACCCCACCGATTT: GTCGCACCCCACCGATTTA
TGCTACGAACACTGACAAA: GCTACGAACACTGACAAAG
TGGTCTCACTGACGGTTCG: GGTCTCACTGACGGTTCGG
AGCGGTCTGGAAATCCTCG: GCGGTCTGGAAATCCTCGC
GGGAGTCATCCAGAGTCTA: GGAGTCATCCAGAGTCTAG
ACTGGTTGGCGAGTCGACC: CTGGTTGGCGAGTCGACCT
TTCGCAAAGAAAAGTAGAC: TCGCAAAGAAAAGTAGACC
ACAACGTCCCATCTCGGGC: CAACGTCCCATCTCGGGCC
CTACACAACGTAACGCCTT: TACACAACGTAACGCCTTT
CATCGCGGATGATAACGAC: ATCGCGGATGATAACGACA
TGTGCTCCGAGCTCAGCCG: GTGCTCCGAGCTCAGCCGG
GTTGAATGTTTTTAAACCC: TTGAATGTTTTTAAACCCG
CACATTGCGACGTACTAGT: ACATTGCGACGTACTAGTC
CACGCCCAGACTGAAACAG: ACGCCCAGACTGAAACAGC
CACAATGACCTTCATCGCG: ACAATGACCTTCATCGCGG
CGAGAAACGCGTATGCATG: GAGAAACGCGTATGCATGT
GGATCTTCTAGGGGAGTGT: GATCTTCTAGGGGAGTGTC
CCCTTGTGAATGGGTTAAC: CCTTGTGAATGGGTTAACA
TTCCCAGGTGGCTCTTTAC: TCCCAGGTGGCTCTTTACT
TGCACCTCCACCGCTGTTT: GCACCTCCACCGCTGTTTG
ATAGGCAGAACCTTAGGGT: TAGGCAGAACCTTAGGGTT
GCTAACGCGGGATCTTCTA: CTAACGCGGGATCTTCTAG
GTCACACGCTTGGCGTATT: TCACACGCTTGGCGTATTA
GACATTAAGCCCATACTTC: ACATTAAGCCCATACTTCA
CTCATCAGCCGTTCGCGCC: TCATCAGCCGTTCGCGCCT
GGGTTTCAGTCCGGCTTCC: GGTTTCAGTCCGGCTTCCG
TGGTGCGCTAGGGGAGTGT: GGTGCGCTAGGGGAGTGTC
AAGGGTTTCAGTCCGGCTT: AGGGTTTCAGTCCGGCTTC
TTGCATGGTAATCGCAGTG: TGCATGGTAATCGCAGTGT
GAAACCCTGCTGGCGCCTA: AAACCCTGCTGGCGCCTAC
TCTTCGCAAAGAAAAGTAG: CTTCGCAAAGAAAAGTAGA
GGGGGTTTAGATAGAAATT: GGGGTTTAGATAGAAATTG
TCCGCAGCTGTTGCATGGT: CCGCAGCTGTTGCATGGTA
TATTGCTCCTTGATGTAGG: ATTGCTCCTTGATGTAGGA
CTTAGCGGTCTGGAAATCC: TTAGCGGTCTGGAAATCCT
GCCCAAGCCGGACAGACGA: CCCAAGCCGGACAGACGAA
ATCTACTAGATTATTCACA: TCTACTAGATTATTCACAA
TAACGCGGGATCTTCTAGG: AACGCGGGATCTTCTAGGG
GACCACTCATGTGCATCGG: ACCACTCATGTGCATCGGA
CAGATCCACGCCCAGACTG: AGATCCACGCCCAGACTGA
TATAGGGCCCACTTTAATA: ATAGGGCCCACTTTAATAC
TGATAACGACAGCCCGGCT: GATAACGACAGCCCGGCTA
CGCCTCTTACCAAATCAGG: GCCTCTTACCAAATCAGGC
TCAGTGCGTTGTCCTCATC: CAGTGCGTTGTCCTCATCG
AATGGTCTCACTGACGGTT: ATGGTCTCACTGACGGTTC
AGTCATCCAGAGTCTAGTC: GTCATCCAGAGTCTAGTCA
GTTTGGGCTAGCCGTATCC: TTTGGGCTAGCCGTATCCA
GGTGCGCTAGGGGAGTGTC: GTGCGCTAGGGGAGTGTCG
CTTTACAGCAGTAAGTTCT: TTTACAGCAGTAAGTTCTT
TTGGGCTAGCCGTATCCAT: TGGGCTAGCCGTATCCATA
ATGTGCATCGGAAATGGTG: TGTGCATCGGAAATGGTGC
TTGCTGTACCTAATGGTCT: TGCTGTACCTAATGGTCTC
GCTTAAGGTTAATGTCGAA: CTTAAGGTTAATGTCGAAA
AGGGTTTTGCTGTACCTAA: GGGTTTTGCTGTACCTAAT
CAAATCAGGCAAGCACCCT: AAATCAGGCAAGCACCCTT
ACCTCCGCTTCCCATGTGC: CCTCCGCTTCCCATGTGCG
TCCACCGCTGTTTGGGCTA: CCACCGCTGTTTGGGCTAG
TCTTCTAGGGGAGTGTCGC: CTTCTAGGGGAGTGTCGCA
GGGAGCTTGAGTCAAAAGC: GGAGCTTGAGTCAAAAGCC
CAATCCGCAGCTGTTGCAT: AATCCGCAGCTGTTGCATG
GCTCAGCCGGCCTATAAGG: CTCAGCCGGCCTATAAGGA
TTAAGGTTAATGTCGAAAC: TAAGGTTAATGTCGAAACC
TTCGAAGAACATGTCTAAA: TCGAAGAACATGTCTAAAC
ACCCGTAAAAGTAGGGGAC: CCCGTAAAAGTAGGGGACC
AACGACAGCCCGGCTATAC: ACGACAGCCCGGCTATACG
AACCTAAAGAAGCGAGAAA: ACCTAAAGAAGCGAGAAAC
GACGAGGAAGGCGCCCAAG: ACGAGGAAGGCGCCCAAGC
GCGCGAACGATGTCGCGGA: CGCGAACGATGTCGCGGAA
AGAGTAAGCTGCCGGAATC: GAGTAAGCTGCCGGAATCG
ATGTGCGCTGCTACGAACA: TGTGCGCTGCTACGAACAC
GCGAGCAATGGTTATCGGT: CGAGCAATGGTTATCGGTC
TTTGTTAAACACAACCGAC: TTGTTAAACACAACCGACA
ACGCGTATGCATGTGCTCC: CGCGTATGCATGTGCTCCG
GGATGGCGCGCACTACACA: GATGGCGCGCACTACACAA
ATATGGCGTAACAAGCGTT: TATGGCGTAACAAGCGTTC
CACCGCTGTTTGGGCTAGC: ACCGCTGTTTGGGCTAGCC
CGGTCCAGGAGGTTGTTTT: GGTCCAGGAGGTTGTTTTT
GTGAGGCATGACCCTTTAC: TGAGGCATGACCCTTTACG
CTGGCGCCTACCAGGCTGC: TGGCGCCTACCAGGCTGCT
TGTACCTAATGGTCTCACT: GTACCTAATGGTCTCACTG
ATTTTTACACACGTACGTT: TTTTTACACACGTACGTTA
TTTTGTGCTCTAGGTCCGG: TTTGTGCTCTAGGTCCGGT
TTAATACGAGCATAATTCA: TAATACGAGCATAATTCAG
AGGATTATTCAATGTACAG: GGATTATTCAATGTACAGG
ATCCCTCATCAGCCGTTCG: TCCCTCATCAGCCGTTCGC
TCAGGACTTGTTCCCACGT: CAGGACTTGTTCCCACGTC
CGGGAGCTTGAGTCAAAAG: GGGAGCTTGAGTCAAAAGC
AGACTGCGGAAGGGTTTCA: GACTGCGGAAGGGTTTCAG
CGCACATTGCGACGTACTA: GCACATTGCGACGTACTAG
CGGGATCTTCTAGGGGAGT: GGGATCTTCTAGGGGAGTG
GGCGGGTGATTCCATCGGT: GCGGGTGATTCCATCGGTT
TAATGGTCTCACTGACGGT: AATGGTCTCACTGACGGTT
GTGTCGCACCACTGGTTGG: TGTCGCACCACTGGTTGGC
ATTGCTAACGCGGGATCTT: TTGCTAACGCGGGATCTTC
TGTGCGCTGCTACGAACAC: GTGCGCTGCTACGAACACT
GTTAAATAATATAGAAGGC: TTAAATAATATAGAAGGCC
AGAAAAGTAGACCTTCCAC: GAAAAGTAGACCTTCCACG
TTGAACCCGCAAGCTGAGT: TGAACCCGCAAGCTGAGTG
CTTAATGCCTCCTAGGGGA: TTAATGCCTCCTAGGGGAG
AGTAAGTTCTTGCTGACGC: GTAAGTTCTTGCTGACGCA
CGTATACCCGCTCAGGATC: GTATACCCGCTCAGGATCC
TAGGATCAAACAGTAACGT: AGGATCAAACAGTAACGTA
TCCGCTTCCCATGACGTGA: CCGCTTCCCATGACGTGAT
CTCTAGATATCTTCACCAC: TCTAGATATCTTCACCACG
AAGTTCTTGCTGACGCACA: AGTTCTTGCTGACGCACAC
AAGATACCGGGCCTCAACG: AGATACCGGGCCTCAACGC
GTACGATAAGATCCTATGC: TACGATAAGATCCTATGCG
TTTTTACACACGTACGTTA: TTTTACACACGTACGTTAA
ATGGGTTAACAGTAGTTTT: TGGGTTAACAGTAGTTTTG
GCTAGGATTATTCAATGTA: CTAGGATTATTCAATGTAC
AGACTGAAACAGCACAAGA: GACTGAAACAGCACAAGAG
GTGAATGGGTTAACAGTAG: TGAATGGGTTAACAGTAGT
TCACGTGAGCGACTGCGTA: CACGTGAGCGACTGCGTAG
TCATCGAGATGCGATGAGA: CATCGAGATGCGATGAGAG
CGCAGTGTCGTCCTGCGAG: GCAGTGTCGTCCTGCGAGC
ATGAGTTAGACTGCGGAAG: TGAGTTAGACTGCGGAAGG
CGGAATCGGACAACACCAA: GGAATCGGACAACACCAAC
CGCAAAGAAAAGTAGACCT: GCAAAGAAAAGTAGACCTT
GACCGAGGGGATCGTTATC: ACCGAGGGGATCGTTATCT
CATGACGTGATTACTCGTG: ATGACGTGATTACTCGTGA
GTTTGAATTTTTACACACG: TTTGAATTTTTACACACGT
GCGCCTCTTACCAAATCAG: CGCCTCTTACCAAATCAGG
AGGCCCCCTATCCTATGTC: GGCCCCCTATCCTATGTCA
AGGATCAAACAGTAACGTA: GGATCAAACAGTAACGTAA
TCCACGTTTATACGGATCT: CCACGTTTATACGGATCTA
GAGGAAGGCGCCCAAGCCG: AGGAAGGCGCCCAAGCCGG
TCGAGATGCGATGAGAGTG: CGAGATGCGATGAGAGTGG
TCTTCACCACGACCTGAAT: CTTCACCACGACCTGAATC
CGATGTTAACAGTGGTCAC: GATGTTAACAGTGGTCACA
TCGCAAAGAAAAGTAGACC: CGCAAAGAAAAGTAGACCT
TGATTCCATCGGTTCCGGT: GATTCCATCGGTTCCGGTA
TAAGTTCTTGCTGACGCAC: AAGTTCTTGCTGACGCACA
GGAGTCATCCAGAGTCTAG: GAGTCATCCAGAGTCTAGT
GCAGCTGTTGCATGGTAAT: CAGCTGTTGCATGGTAATC
ATTCAATGTACAGGGGGAG: TTCAATGTACAGGGGGAGT
CATGTGCTCCGAGCTCAGC: ATGTGCTCCGAGCTCAGCC
GCGTAAGATACCGGGCCTC: CGTAAGATACCGGGCCTCA
TTCCCATGACGTGATTACT: TCCCATGACGTGATTACTC
TAAGATCCTATGCGGATAC: AAGATCCTATGCGGATACG
CAGCCCGGCTATACGGGAG: AGCCCGGCTATACGGGAGC
GAAAATCCATCTTGCGATC: AAAATCCATCTTGCGATCG
AAGGGACATGGGTGCCAAG: AGGGACATGGGTGCCAAGA
GGGTGCCAAGACTCGCGAT: GGTGCCAAGACTCGCGATA
GCCGGAATCGGACAACACC: CCGGAATCGGACAACACCA
GCACCTAGTGGGAACAAGT: CACCTAGTGGGAACAAGTC
TCATCAGCCGTTCGCGCCT: CATCAGCCGTTCGCGCCTC
GATACGATATTCACCAATG: ATACGATATTCACCAATGC
GGCGAGTCGACCTCCGCTT: GCGAGTCGACCTCCGCTTC
TACGGATCTATCGACGAGG: ACGGATCTATCGACGAGGA
TGTTTTTAAACCCGTAAAA: GTTTTTAAACCCGTAAAAG
ATCCTATGCGGATACGATA: TCCTATGCGGATACGATAT
ATCTGGCTTCATTGCTAAC: TCTGGCTTCATTGCTAACG
TAGGGTTTTGCTGTACCTA: AGGGTTTTGCTGTACCTAA
TGGTCAGATCCACGCCCAG: GGTCAGATCCACGCCCAGA
CGACTACAAGAAGGGTGCT: GACTACAAGAAGGGTGCTC
CCCAGGTGGCTCTTTACTT: CCAGGTGGCTCTTTACTTA
AGGCAGTAGACCGAGGGGA: GGCAGTAGACCGAGGGGAT
GTAAGTTCTTGCTGACGCA: TAAGTTCTTGCTGACGCAC
CCGGGGTTCATCTACTAGA: CGGGGTTCATCTACTAGAT
TCAATGTACAGGGGGAGTC: CAATGTACAGGGGGAGTCA
CTATACGGGAGCTTGAGTC: TATACGGGAGCTTGAGTCA
GATTTAAGTCGACCTCCGC: ATTTAAGTCGACCTCCGCT
GTTTTGCTCATACGAATCC: TTTTGCTCATACGAATCCA
ACATTAAGCCCATACTTCA: CATTAAGCCCATACTTCAT
GAGAGCCCACAATAGATGG: AGAGCCCACAATAGATGGA
TTTTTGTGCTCTAGGTCCG: TTTTGTGCTCTAGGTCCGG
AATGGTTATCGGTCTAGGC: ATGGTTATCGGTCTAGGCT
AGGGCCCACTTTAATACGA: GGGCCCACTTTAATACGAG
ATTTAAGTCGACCTCCGCT: TTTAAGTCGACCTCCGCTT
AATCCAGCGTATTGCCCCG: ATCCAGCGTATTGCCCCGT
ACCAACTCACGTGAGCGAC: CCAACTCACGTGAGCGACT
ACAACCGACATTAAGCCCA: CAACCGACATTAAGCCCAT
TCGCGATACCCCAAGAATT: CGCGATACCCCAAGAATTG
CTCCGCTTCCCATGTGCGC: TCCGCTTCCCATGTGCGCT
ATCTACGACTAGTTACGGT: TCTACGACTAGTTACGGTT
TCTTTACTTAGTTTGACTA: CTTTACTTAGTTTGACTAG
ACTAGTCTCATCGAGATGC: CTAGTCTCATCGAGATGCG
CTCTAGGTCCGGTGTCACA: TCTAGGTCCGGTGTCACAA
TTCACAATGACCTTCATCG: TCACAATGACCTTCATCGC
GCGTATTAGTCCCCGCGTT: CGTATTAGTCCCCGCGTTC
GACTAGGGGAGTGTCGCAC: ACTAGGGGAGTGTCGCACC
AAACGCGTATGCATGTGCT: AACGCGTATGCATGTGCTC
AACTCACGTGAGCGACTGC: ACTCACGTGAGCGACTGCG
GCTACGAACACTGACAAAG: CTACGAACACTGACAAAGG
TAACAGTGGTCACACGCTT: AACAGTGGTCACACGCTTG
TCATTGCTAACGCGGGATC: CATTGCTAACGCGGGATCT
TCTGGAAATCCTCGCGCAC: CTGGAAATCCTCGCGCACA
TCGTTATCTACGACTAGTT: CGTTATCTACGACTAGTTA
AATCCTCGCGCACATTGCG: ATCCTCGCGCACATTGCGA
GCCTCAACGCTAGGATTAT: CCTCAACGCTAGGATTATT
GGGTGCTCTAGATATCTTC: GGTGCTCTAGATATCTTCA
GGAAATGGTGCATGCTCTT: GAAATGGTGCATGCTCTTA
CAATCTTCCGGGGGGTTTA: AATCTTCCGGGGGGTTTAG
CCATCGGTTCCGGTAAATA: CATCGGTTCCGGTAAATAC
GATCTGGTGCGCTAGGGGA: ATCTGGTGCGCTAGGGGAG
TTCACCATGAGTTAGACTG: TCACCATGAGTTAGACTGC
AGCGTTCGAAGAACATGTC: GCGTTCGAAGAACATGTCT
CATGTTTTGCTCATACGAA: ATGTTTTGCTCATACGAAT
CTCGGTGAGAGCCCACAAT: TCGGTGAGAGCCCACAATA
TGAACCCGCAAGCTGAGTG: GAACCCGCAAGCTGAGTGC
ATCCGTGTTGCCGGTCCAG: TCCGTGTTGCCGGTCCAGG
TGCGATCGGATGGCGCGCA: GCGATCGGATGGCGCGCAC
TCCCAGGTCTCGTGAGGCA: CCCAGGTCTCGTGAGGCAT
AAGCTGAGTGCTTAAGGTT: AGCTGAGTGCTTAAGGTTA
AATGCCTCCTAGGGGAGTG: ATGCCTCCTAGGGGAGTGT
GATACCGGGCCTCAACGCT: ATACCGGGCCTCAACGCTA
TCAGGCAAGCACCCTTTGT: CAGGCAAGCACCCTTTGTT
TTCAGTGCGTTGTCCTCAT: TCAGTGCGTTGTCCTCATC
CCTGGTGACTATGCTAGTG: CTGGTGACTATGCTAGTGG
ATTATTCAATGTACAGGGG: TTATTCAATGTACAGGGGG
GCGTTGTCCTCATCGTAAT: CGTTGTCCTCATCGTAATT
ACAAGTCGACCTCCGCTTC: CAAGTCGACCTCCGCTTCC
CGCTCAGGATCCACAAGCC: GCTCAGGATCCACAAGCCC
ACTCGTGAGCGCTCGGTGA: CTCGTGAGCGCTCGGTGAG
CTCCATGTTTTGCTCATAC: TCCATGTTTTGCTCATACG
AGCCGTATCCATATCTGGC: GCCGTATCCATATCTGGCT
GACTTGTTCCCACGTCGAG: ACTTGTTCCCACGTCGAGC
TGACTATGCTAGTGGTACC: GACTATGCTAGTGGTACCC
GGAGTGTCGCACCACTGGT: GAGTGTCGCACCACTGGTT
AATGTACAGGGGGAGTCAT: ATGTACAGGGGGAGTCATC
TCCATCTTGCGATCGGATG: CCATCTTGCGATCGGATGG
ACACAACCGACATTAAGCC: CACAACCGACATTAAGCCC
AGCTGCCGGAATCGGACAA: GCTGCCGGAATCGGACAAC
ATACCGGGCCTCAACGCTA: TACCGGGCCTCAACGCTAG
TGTGCATCGGAAATGGTGC: GTGCATCGGAAATGGTGCA
GGAGTCGACCTCCGCTTCC: GAGTCGACCTCCGCTTCCC
TCAGCTCCATGTTTTGCTC: CAGCTCCATGTTTTGCTCA
TTGAATTTTTACACACGTA: TGAATTTTTACACACGTAC
CAACACCAACTCACGTGAG: AACACCAACTCACGTGAGC
CTAGTTACGGTTGAATGTT: TAGTTACGGTTGAATGTTT
TGCTGTACCTAATGGTCTC: GCTGTACCTAATGGTCTCA
ACCGCTGTTTGGGCTAGCC: CCGCTGTTTGGGCTAGCCG
ATCCATCTTGCGATCGGAT: TCCATCTTGCGATCGGATG
GTAAAAGTAGGGGACCACT: TAAAAGTAGGGGACCACTC
CGTAAGATACCGGGCCTCA: GTAAGATACCGGGCCTCAA
CATGGGTGCCAAGACTCGC: ATGGGTGCCAAGACTCGCG
CCTGAATCCCTCATCAGCC: CTGAATCCCTCATCAGCCG
CGCTAGGATTATTCAATGT: GCTAGGATTATTCAATGTA
TGCACCTGGTGACTATGCT: GCACCTGGTGACTATGCTA
ATAGAAATTGTACACAGAA: TAGAAATTGTACACAGAAA
TCTACGACTAGTTACGGTT: CTACGACTAGTTACGGTTG
AGGCTGCTTGTTAAATAAT: GGCTGCTTGTTAAATAATA
GGCTATTTTATTGCTCCTT: GCTATTTTATTGCTCCTTG
GGCTGCTTGTTAAATAATA: GCTGCTTGTTAAATAATAT
GGCGTATTAGTCCCCGCGT: GCGTATTAGTCCCCGCGTT
CGGTGTGATCGTGGAGGGG: GGTGTGATCGTGGAGGGGG
ACGAACACTGACAAAGGGA: CGAACACTGACAAAGGGAC
CGATCGGATGGCGCGCACT: GATCGGATGGCGCGCACTA
TACACAACGTAACGCCTTT: ACACAACGTAACGCCTTTA
TCAGGTCTCCTAATACTGT: CAGGTCTCCTAATACTGTG
GAATTGAGACACAACCTAA: AATTGAGACACAACCTAAA
GGTTTCAGTCCGGCTTCCG: GTTTCAGTCCGGCTTCCGG
GGCTATACGGGAGCTTGAG: GCTATACGGGAGCTTGAGT
TCTCACTGACGGTTCGGTG: CTCACTGACGGTTCGGTGT
TAGACCGAGGGGATCGTTA: AGACCGAGGGGATCGTTAT
CATGCACCTCCACCGCTGT: ATGCACCTCCACCGCTGTT
TCGGAAATGGTGCATGCTC: CGGAAATGGTGCATGCTCT
GAATGTTTTTAAACCCGTA: AATGTTTTTAAACCCGTAA
TGGTTGGCGAGTCGACCTC: GGTTGGCGAGTCGACCTCC
ATTTACGGAGATCTGGTGC: TTTACGGAGATCTGGTGCG
GAACATATTTCACGGAAGA: AACATATTTCACGGAAGAT
TAATTCAGTGCGTTGTCCT: AATTCAGTGCGTTGTCCTC
CTTTACGAAAGAAGCCTCT: TTTACGAAAGAAGCCTCTT
GATTCCATCGGTTCCGGTA: ATTCCATCGGTTCCGGTAA
GGTTGGCGAGTCGACCTCC: GTTGGCGAGTCGACCTCCG
CTGGTGCGCTAGGGGAGTG: TGGTGCGCTAGGGGAGTGT
TTAAGCCCATACTTCATTT: TAAGCCCATACTTCATTTA
TGTTTTTGTGCTCTAGGTC: GTTTTTGTGCTCTAGGTCC
CCCGTACGTACGATAAGAT: CCGTACGTACGATAAGATC
GAGTGTAGTCTTTCTTAGG: AGTGTAGTCTTTCTTAGGA
ATCCACGCCCAGACTGAAA: TCCACGCCCAGACTGAAAC
TTAGTTTGACTAGGGGAGT: TAGTTTGACTAGGGGAGTG
TATCGGTCTAGGCTATTTT: ATCGGTCTAGGCTATTTTA
AAGTCGACCTCCGCTTCCC: AGTCGACCTCCGCTTCCCA AGTCGACCTCCGCTTCCCA
GTTGAACCCGCAAGCTGAG: TTGAACCCGCAAGCTGAGT
CTTGTTCCCACGTCGAGCG: TTGTTCCCACGTCGAGCGC
CTTCCGGGGGGTTTAGATA: TTCCGGGGGGTTTAGATAG
TCCCATCTCGGGCCCCTCT: CCCATCTCGGGCCCCTCTT
CTCTTAATGCCTCCTAGGG: TCTTAATGCCTCCTAGGGG
AGTTACGGTTGAATGTTTT: GTTACGGTTGAATGTTTTT
CTAGGTCCGGTGTCACAAC: TAGGTCCGGTGTCACAACG
GTCGCGGAAAATCCATCTT: TCGCGGAAAATCCATCTTG
AACACCAACTCACGTGAGC: ACACCAACTCACGTGAGCG
GGATACGATATTCACCAAT: GATACGATATTCACCAATG
CAGCCGTTCGCGCCTCTTA: AGCCGTTCGCGCCTCTTAC
GAACATGTCTAAACTGCTC: AACATGTCTAAACTGCTCA
CCATGACGTGATTACTCGT: CATGACGTGATTACTCGTG
GCGGTCTGGAAATCCTCGC: CGGTCTGGAAATCCTCGCG
TGAATGGGTTAACAGTAGT: GAATGGGTTAACAGTAGTT
GCGGGATCTTCTAGGGGAG: CGGGATCTTCTAGGGGAGT
CGTATGCATGTGCTCCGAG: GTATGCATGTGCTCCGAGC
CTAGGCTATTTTATTGCTC: TAGGCTATTTTATTGCTCC
GAAGCGAGAAACGCGTATG: AAGCGAGAAACGCGTATGC
ACCGATTTAAGTCGACCTC: CCGATTTAAGTCGACCTCC
TCCAGAGTCTAGTCAGCTC: CCAGAGTCTAGTCAGCTCC
GCGATCGGATGGCGCGCAC: CGATCGGATGGCGCGCACT
TATACGGATCTATCGACGA: ATACGGATCTATCGACGAG
TGTTCCCACGTCGAGCGCG: GTTCCCACGTCGAGCGCGA
GTCGCACCTAGTGGGAACA: TCGCACCTAGTGGGAACAA
CCTTAGGGTTTTGCTGTAC: CTTAGGGTTTTGCTGTACC
GACAAAGGGACATGGGTGC: ACAAAGGGACATGGGTGCC
CCTGCGAGCAATGGTTATC: CTGCGAGCAATGGTTATCG
GGATTATTCAATGTACAGG: GATTATTCAATGTACAGGG
GTTTTTAAACCCGTAAAAG: TTTTTAAACCCGTAAAAGT
AGGAAGGCGCCCAAGCCGG: GGAAGGCGCCCAAGCCGGA
TCACACGCTTGGCGTATTA: CACACGCTTGGCGTATTAG
TTGAATGTTTTTAAACCCG: TGAATGTTTTTAAACCCGT
ACGTAACACAATCCGCAGC: CGTAACACAATCCGCAGCT
AAAGCCCTCAGCGGGTACC: AAGCCCTCAGCGGGTACCC
CCCGGCTATACGGGAGCTT: CCGGCTATACGGGAGCTTG
ATTGGTTGAACCCGCAAGC: TTGGTTGAACCCGCAAGCT
TTTTGCTGTACCTAATGGT: TTTGCTGTACCTAATGGTC
ATAACGACAGCCCGGCTAT: TAACGACAGCCCGGCTATA
TAAAGAAGCGAGAAACGCG: AAAGAAGCGAGAAACGCGT
CTGACAAAGGGACATGGGT: TGACAAAGGGACATGGGTG
CGCGGAAAATCCATCTTGC: GCGGAAAATCCATCTTGCG
AACGCGGGATCTTCTAGGG: ACGCGGGATCTTCTAGGGG
CAGAGGCGGAGTCGACCTC: AGAGGCGGAGTCGACCTCC
TCCTGCGAGCAATGGTTAT: CCTGCGAGCAATGGTTATC
GGGGAGTGTCGCACCCCAC: GGGAGTGTCGCACCCCACC
TTAACAGTGGTCACACGCT: TAACAGTGGTCACACGCTT
CCCTATCCTATGTCACTGA: CCTATCCTATGTCACTGAC
TTTCTTAGGATCAAACAGT: TTCTTAGGATCAAACAGTA
GACTCGCGATACCCCAAGA: ACTCGCGATACCCCAAGAA
CACTGACAAAGGGACATGG: ACTGACAAAGGGACATGGG
ATGGTGCATGCTCTTAATG: TGGTGCATGCTCTTAATGC
ATGTAGGACAGGGGATTGG: TGTAGGACAGGGGATTGGT
CGTAACAAGCGTTCGAAGA: GTAACAAGCGTTCGAAGAA
AACGCTAGGATTATTCAAT: ACGCTAGGATTATTCAATG
TCTTAGGATCAAACAGTAA: CTTAGGATCAAACAGTAAC
CCAGGTGGCTCTTTACTTA: CAGGTGGCTCTTTACTTAG
ATGGTAATCGCAGTGTCGT: TGGTAATCGCAGTGTCGTC
TACGAAAGAAGCCTCTTCG: ACGAAAGAAGCCTCTTCGC
AGCCCACAATAGATGGATA: GCCCACAATAGATGGATAG
ACGTACGTTAATTTCACCA: CGTACGTTAATTTCACCAT
AATCGCGTAAGATACCGGG: ATCGCGTAAGATACCGGGC
CGGTTGAATGTTTTTAAAC: GGTTGAATGTTTTTAAACC
TCCCATGTGCGCTGCTACG: CCCATGTGCGCTGCTACGA
TCGCGCACATTGCGACGTA: CGCGCACATTGCGACGTAC
TGGCGTAACAAGCGTTCGA: GGCGTAACAAGCGTTCGAA
GGGTGATTCCATCGGTTCC: GGTGATTCCATCGGTTCCG
GACGTACTAGTCTCATCGA: ACGTACTAGTCTCATCGAG
TATCTGGCTTCATTGCTAA: ATCTGGCTTCATTGCTAAC
GCGGATGATAACGACAGCC: CGGATGATAACGACAGCCC
TCAGCCGGCCTATAAGGAA: CAGCCGGCCTATAAGGAAA
GAGTGTCGCACCACTGGTT: AGTGTCGCACCACTGGTTG
GCGTATTGCCCCGTACGTA: CGTATTGCCCCGTACGTAC
TAATCGCAGTGTCGTCCTG: AATCGCAGTGTCGTCCTGC
CCTCTTCGCAAAGAAAAGT: CTCTTCGCAAAGAAAAGTA
AGCTGTTGCATGGTAATCG: GCTGTTGCATGGTAATCGC
CCAAGACTCGCGATACCCC: CAAGACTCGCGATACCCCA
CTACCAGGCTGCTTGTTAA: TACCAGGCTGCTTGTTAAA
TGGCGCGCACTACACAACG: GGCGCGCACTACACAACGT
AAGCACGTATACCCGCTCA: AGCACGTATACCCGCTCAG
TGCTCTAGGTCCGGTGTCA: GCTCTAGGTCCGGTGTCAC
CTCCGCTTCCCAGGTGGCT: TCCGCTTCCCAGGTGGCTC
GCTCTTTACTTAGTTTGAC: CTCTTTACTTAGTTTGACT
ACGAAAGAAGCCTCTTCGC: CGAAAGAAGCCTCTTCGCA
AAATTGTACACAGAAATAT: AATTGTACACAGAAATATG
ATCTGGTGCGCTAGGGGAG: TCTGGTGCGCTAGGGGAGT
CACGTATACCCGCTCAGGA: ACGTATACCCGCTCAGGAT
CGATACCCCAAGAATTGAG: GATACCCCAAGAATTGAGA
TGCGGATACGATATTCACC: GCGGATACGATATTCACCA
CGAGGGGATCGTTATCTAC: GAGGGGATCGTTATCTACG
GGTCTCACTGACGGTTCGG: GTCTCACTGACGGTTCGGT
GACGCACACCGGGCCTAAT: ACGCACACCGGGCCTAATC
TCAGCGGGTACCCAGGCAG: CAGCGGGTACCCAGGCAGT
ACCACTGGTTGGCGAGTCG: CCACTGGTTGGCGAGTCGA
ATTTCACGGAAGATGCGAT: TTTCACGGAAGATGCGATG
CTTCCGGTTATAGGGCCCA: TTCCGGTTATAGGGCCCAC
CGAACACTGACAAAGGGAC: GAACACTGACAAAGGGACA
GAACCTTAGGGTTTTGCTG: AACCTTAGGGTTTTGCTGT
GTCCAGGAGGTTGTTTTTG: TCCAGGAGGTTGTTTTTGT
TGTCACTGACATCCGTGTT: GTCACTGACATCCGTGTTG
GCTTCCCAGGTCTCGTGAG: CTTCCCAGGTCTCGTGAGG
TGCGGAAGGGTTTCAGTCC: GCGGAAGGGTTTCAGTCCG
TTACCAAATCAGGCAAGCA: TACCAAATCAGGCAAGCAC
TACTCGTGAGCGCTCGGTG: ACTCGTGAGCGCTCGGTGA
CTTCCCAGGTGGCTCTTTA: TTCCCAGGTGGCTCTTTAC
ACCAAATCAGGCAAGCACC: CCAAATCAGGCAAGCACCC
GTACAGGGGGAGTCATCCA: TACAGGGGGAGTCATCCAG
ATCCGCAGCTGTTGCATGG: TCCGCAGCTGTTGCATGGT
TTAGTCCCCGCGTTCTACT: TAGTCCCCGCGTTCTACTG
TACATTAGAACATATTTCA: ACATTAGAACATATTTCAC
TACGATATTCACCAATGCA: ACGATATTCACCAATGCAC
GAGTAAGCTGCCGGAATCG: AGTAAGCTGCCGGAATCGG
AGGTGGCTCTTTACTTAGT: GGTGGCTCTTTACTTAGTT
CCAGACTGAAACAGCACAA: CAGACTGAAACAGCACAAG
ACCTCCGCTTCCCATGACG: CCTCCGCTTCCCATGACGT
AATAGATGGATAGGCAGAA: ATAGATGGATAGGCAGAAC
TGCTAGTGGTACCCTTGTG: GCTAGTGGTACCCTTGTGA
TCCGCTTCCCATGTGCGCT: CCGCTTCCCATGTGCGCTG
AGGGGAGTGTCGCACCGTC: GGGGAGTGTCGCACCGTCA
GTTACGGTTGAATGTTTTT: TTACGGTTGAATGTTTTTA
CTTTAATACGAGCATAATT: TTTAATACGAGCATAATTC
GACAACACCAACTCACGTG: ACAACACCAACTCACGTGA
TCGCGTAAGATACCGGGCC: CGCGTAAGATACCGGGCCT
GGGATCTTCTAGGGGAGTG: GGATCTTCTAGGGGAGTGT
GCCTAATCGCGTAAGATAC: CCTAATCGCGTAAGATACC
CCCATGACGTGATTACTCG: CCATGACGTGATTACTCGT
TTCCACGTTTATACGGATC: TCCACGTTTATACGGATCT
TTAAACACAACCGACATTA: TAAACACAACCGACATTAA
TCGGGCCCCTCTTAGCGGT: CGGGCCCCTCTTAGCGGTC
CTTCCACGTTTATACGGAT: TTCCACGTTTATACGGATC
TTGAGACACAACCTAAAGA: TGAGACACAACCTAAAGAA
CTTCATCGCGGATGATAAC: TTCATCGCGGATGATAACG
CCGGTGTCACAACGTCCCA: CGGTGTCACAACGTCCCAT
TTCATCTACTAGATTATTC: TCATCTACTAGATTATTCA
CGTTAATTTCACCATGAGT: GTTAATTTCACCATGAGTT
AAAGAAGCGAGAAACGCGT: AAGAAGCGAGAAACGCGTA
ATAGGGCCCACTTTAATAC: TAGGGCCCACTTTAATACG
ACCACGACCTGAATCCCTC: CCACGACCTGAATCCCTCA
TGTTGCATGGTAATCGCAG: GTTGCATGGTAATCGCAGT
AATCCGCAGCTGTTGCATG: ATCCGCAGCTGTTGCATGG
CCGTATCCATATCTGGCTT: CGTATCCATATCTGGCTTC
CAGCGGGTACCCAGGCAGT: AGCGGGTACCCAGGCAGTA
TGCGTAGACAGTCGACTAC: GCGTAGACAGTCGACTACA
TGGAGGGGGCTCGCCATTG: GGAGGGGGCTCGCCATTGC
ACCCCAAGAATTGAGACAC: CCCCAAGAATTGAGACACA
CACCGTCAGAGGCGGAGTC: ACCGTCAGAGGCGGAGTCG
CCGTGTTGCCGGTCCAGGA: CGTGTTGCCGGTCCAGGAG
ATCGACGAGGAAGGCGCCC: TCGACGAGGAAGGCGCCCA
GCTGTTTGGGCTAGCCGTA: CTGTTTGGGCTAGCCGTAT
CGTTTATACGGATCTATCG: GTTTATACGGATCTATCGA
ACAGTAACGTAACACAATC: CAGTAACGTAACACAATCC
GAGGCATGACCCTTTACGA: AGGCATGACCCTTTACGAA
GGTCCAGGAGGTTGTTTTT: GTCCAGGAGGTTGTTTTTG
GACTATGCTAGTGGTACCC: ACTATGCTAGTGGTACCCT
TCCGGCTTCCGGTTATAGG: CCGGCTTCCGGTTATAGGG
TCTTACCAAATCAGGCAAG: CTTACCAAATCAGGCAAGC
CGAGCATAATTCAGTGCGT: GAGCATAATTCAGTGCGTT
TATTGCCCCGTACGTACGA: ATTGCCCCGTACGTACGAT
GGCTTCCGGTTATAGGGCC: GCTTCCGGTTATAGGGCCC
CATGTGCATCGGAAATGGT: ATGTGCATCGGAAATGGTG
GGATCTATCGACGAGGAAG: GATCTATCGACGAGGAAGG
TAAATAATATAGAAGGCCC: AAATAATATAGAAGGCCCC
CACCGATTTAAGTCGACCT: ACCGATTTAAGTCGACCTC
GGGAGTGTCGCACCTAGTG: GGAGTGTCGCACCTAGTGG
AAACACAACCGACATTAAG: AACACAACCGACATTAAGC
CGACTAGTTACGGTTGAAT: GACTAGTTACGGTTGAATG
TCCATATCTGGCTTCATTG: CCATATCTGGCTTCATTGC
CACACGTACGTTAATTTCA: ACACGTACGTTAATTTCAC
CGAAAGAAGCCTCTTCGCA: GAAAGAAGCCTCTTCGCAA
ATGACCTTCATCGCGGATG: TGACCTTCATCGCGGATGA
TCGACCTCCGCTTCCCATG: CGACCTCCGCTTCCCATGA CGACCTCCGCTTCCCATGT
TTTTATTGCTCCTTGATGT: TTTATTGCTCCTTGATGTA
ACAGCAGTAAGTTCTTGCT: CAGCAGTAAGTTCTTGCTG
GCGTAGACAGTCGACTACA: CGTAGACAGTCGACTACAA
TAAGGTTAATGTCGAAACC: AAGGTTAATGTCGAAACCC
ACCAATGCACCTGGTGACT: CCAATGCACCTGGTGACTA
CTCTTCGCAAAGAAAAGTA: TCTTCGCAAAGAAAAGTAG
ACCCTTTGTTAAACACAAC: CCCTTTGTTAAACACAACC
ACCCAATCTTCCGGGGGGT: CCCAATCTTCCGGGGGGTT
TTCGCGCCTCTTACCAAAT: TCGCGCCTCTTACCAAATC
TCAGATCCACGCCCAGACT: CAGATCCACGCCCAGACTG
CGGTTATAGGGCCCACTTT: GGTTATAGGGCCCACTTTA
CACGTCGAGCGCGAACGAT: ACGTCGAGCGCGAACGATG
ACGTCCCATCTCGGGCCCC: CGTCCCATCTCGGGCCCCT
TGACATCCGTGTTGCCGGT: GACATCCGTGTTGCCGGTC
CTCCGAGCTCAGCCGGCCT: TCCGAGCTCAGCCGGCCTA
AAGATGCGATGTTAACAGT: AGATGCGATGTTAACAGTG
TGGTGCATGCTCTTAATGC: GGTGCATGCTCTTAATGCC
TAATTAACACCCAATCTTC: AATTAACACCCAATCTTCC
TAGGGGACCACTCATGTGC: AGGGGACCACTCATGTGCA
ATATTTCACGGAAGATGCG: TATTTCACGGAAGATGCGA
GGTTTGAATTTTTACACAC: GTTTGAATTTTTACACACG
TCACGGAAGATGCGATGTT: CACGGAAGATGCGATGTTA
TGTCGCACCGTCAGAGGCG: GTCGCACCGTCAGAGGCGG
GACGTGATTACTCGTGAGC: ACGTGATTACTCGTGAGCG
AGCACCCTTTGTTAAACAC: GCACCCTTTGTTAAACACA
TCACCACGACCTGAATCCC: CACCACGACCTGAATCCCT
TGTAGTCTTTCTTAGGATC: GTAGTCTTTCTTAGGATCA
ATTGCTCCTTGATGTAGGA: TTGCTCCTTGATGTAGGAC
TCCTTGATGTAGGACAGGG: CCTTGATGTAGGACAGGGG
CCCTCTTAGCGGTCTGGAA: CCTCTTAGCGGTCTGGAAA
TCTAGGTCCGGTGTCACAA: CTAGGTCCGGTGTCACAAC
CTAGTGGGAACAAGTCGAC: TAGTGGGAACAAGTCGACC
CGAACGATGTCGCGGAAAA: GAACGATGTCGCGGAAAAT
TTAATGCCTCCTAGGGGAG: TAATGCCTCCTAGGGGAGT
CCCATGTGCGCTGCTACGA: CCATGTGCGCTGCTACGAA
TCGAAGAACATGTCTAAAC: CGAAGAACATGTCTAAACT
ACTGACAAAGGGACATGGG: CTGACAAAGGGACATGGGT
GATATCTTCACCACGACCT: ATATCTTCACCACGACCTG
GTGTCGCACCGTCAGAGGC: TGTCGCACCGTCAGAGGCG
CCGCTTCCCATGTGCGCTG: CGCTTCCCATGTGCGCTGC
ACGGTTGAATGTTTTTAAA: CGGTTGAATGTTTTTAAAC
TAACAAGCGTTCGAAGAAC: AACAAGCGTTCGAAGAACA
GAAGAACATGTCTAAACTG: AAGAACATGTCTAAACTGC
AGAAGCGAGAAACGCGTAT: GAAGCGAGAAACGCGTATG
GCGCTGCTACGAACACTGA: CGCTGCTACGAACACTGAC
GGGCTCGCCATTGCTCAGG: GGCTCGCCATTGCTCAGGA
ATCGCGGATGATAACGACA: TCGCGGATGATAACGACAG
TCATCCAGAGTCTAGTCAG: CATCCAGAGTCTAGTCAGC
TTGCCCCGTACGTACGATA: TGCCCCGTACGTACGATAA
AAGCCCGGGGTTCATCTAC: AGCCCGGGGTTCATCTACT
TCCATGTTTTGCTCATACG: CCATGTTTTGCTCATACGA
CCCAGGCAGTAGACCGAGG: CCAGGCAGTAGACCGAGGG
TGCTTGTTAAATAATATAG: GCTTGTTAAATAATATAGA
AGGGGATCGTTATCTACGA: GGGGATCGTTATCTACGAC
CACGGAAGATGCGATGTTA: ACGGAAGATGCGATGTTAA
CGTATCCATATCTGGCTTC: GTATCCATATCTGGCTTCA
GGCAGAACCTTAGGGTTTT: GCAGAACCTTAGGGTTTTG
CGCCCAAGCCGGACAGACG: GCCCAAGCCGGACAGACGA
GTTGCCGGTCCAGGAGGTT: TTGCCGGTCCAGGAGGTTG
CATTGCGACGTACTAGTCT: ATTGCGACGTACTAGTCTC
ATGCACCTGGTGACTATGC: TGCACCTGGTGACTATGCT
TCAAACAGTAACGTAACAC: CAAACAGTAACGTAACACA
GCCGTTCGCGCCTCTTACC: CCGTTCGCGCCTCTTACCA
TCGCAGTGTCGTCCTGCGA: CGCAGTGTCGTCCTGCGAG
AAATCAGGCAAGCACCCTT: AATCAGGCAAGCACCCTTT
GAGGGGGCTCGCCATTGCT: AGGGGGCTCGCCATTGCTC
GTAGACCGAGGGGATCGTT: TAGACCGAGGGGATCGTTA
CTGCTGGCGCCTACCAGGC: TGCTGGCGCCTACCAGGCT
AGATCCTATGCGGATACGA: GATCCTATGCGGATACGAT
GGTCTGGAAATCCTCGCGC: GTCTGGAAATCCTCGCGCA
ATACTGTGGTCAGATCCAC: TACTGTGGTCAGATCCACG
TCCGCTTCCCAGGTCTCGT: CCGCTTCCCAGGTCTCGTG
GACATCCGTGTTGCCGGTC: ACATCCGTGTTGCCGGTCC
GAGCGACTGCGTAGACAGT: AGCGACTGCGTAGACAGTC
TCACAACGTCCCATCTCGG: CACAACGTCCCATCTCGGG
GCGCGCACTACACAACGTA: CGCGCACTACACAACGTAA
TTGTCCTCATCGTAATTAA: TGTCCTCATCGTAATTAAC
CCCAATCTTCCGGGGGGTT: CCAATCTTCCGGGGGGTTT
ACAGGGGGAGTCATCCAGA: CAGGGGGAGTCATCCAGAG
TAGTCCCCGCGTTCTACTG: AGTCCCCGCGTTCTACTGA
ATGCGGATACGATATTCAC: TGCGGATACGATATTCACC
CTATTTTATTGCTCCTTGA: TATTTTATTGCTCCTTGAT
GTTCGGTGTGATCGTGGAG: TTCGGTGTGATCGTGGAGG
ATGCTAGTGGTACCCTTGT: TGCTAGTGGTACCCTTGTG
CCTCCTAGGGGAGTGTCGC: CTCCTAGGGGAGTGTCGCA
AAGAAAAGTAGACCTTCCA: AGAAAAGTAGACCTTCCAC
ATGACCCTTTACGAAAGAA: TGACCCTTTACGAAAGAAG
TCGAGCGCGAACGATGTCG: CGAGCGCGAACGATGTCGC
GACTACAAGAAGGGTGCTC: ACTACAAGAAGGGTGCTCT
GCACCACTGGTTGGCGAGT: CACCACTGGTTGGCGAGTC
GAAGCACGTATACCCGCTC: AAGCACGTATACCCGCTCA
GTCTAGGCTATTTTATTGC: TCTAGGCTATTTTATTGCT
CGCGGGATCTTCTAGGGGA: GCGGGATCTTCTAGGGGAG
CGCCTTTACAGCAGTAAGT: GCCTTTACAGCAGTAAGTT
GCGACTGCGTAGACAGTCG: CGACTGCGTAGACAGTCGA
ACTGTGGTCAGATCCACGC: CTGTGGTCAGATCCACGCC
CAGCTCCATGTTTTGCTCA: AGCTCCATGTTTTGCTCAT
CGTATTGCCCCGTACGTAC: GTATTGCCCCGTACGTACG
ACCTTAGGGTTTTGCTGTA: CCTTAGGGTTTTGCTGTAC
TGGCTTCATTGCTAACGCG: GGCTTCATTGCTAACGCGG
TACTAGATTATTCACAATG: ACTAGATTATTCACAATGA
GTCTCCTAATACTGTGGTC: TCTCCTAATACTGTGGTCA
CAGGAGGTTGTTTTTGTGC: AGGAGGTTGTTTTTGTGCT
CCACAAGCCCGGGGTTCAT: CACAAGCCCGGGGTTCATC
TTTTACACACGTACGTTAA: TTTACACACGTACGTTAAT
ACACCAACTCACGTGAGCG: CACCAACTCACGTGAGCGA
CGTACGTTAATTTCACCAT: GTACGTTAATTTCACCATG
CCGTCAGAGGCGGAGTCGA: CGTCAGAGGCGGAGTCGAC
CCAGCGTATTGCCCCGTAC: CAGCGTATTGCCCCGTACG
CGCACCACTGGTTGGCGAG: GCACCACTGGTTGGCGAGT
ATTAGAACATATTTCACGG: TTAGAACATATTTCACGGA
CAAACAGTAACGTAACACA: AAACAGTAACGTAACACAA
TATGGCGTAACAAGCGTTC: ATGGCGTAACAAGCGTTCG
CCGACATTAAGCCCATACT: CGACATTAAGCCCATACTT
TAGACTGCGGAAGGGTTTC: AGACTGCGGAAGGGTTTCA
CCTAGGGGAGTGTCGCACC: CTAGGGGAGTGTCGCACCC
CCACCGATTTAAGTCGACC: CACCGATTTAAGTCGACCT
ACCTAGTGGGAACAAGTCG: CCTAGTGGGAACAAGTCGA
ACCTCCACCGCTGTTTGGG: CCTCCACCGCTGTTTGGGC
TCCGGGGGGTTTAGATAGA: CCGGGGGGTTTAGATAGAA
GACCTCCGCTTCCCAGGTC: ACCTCCGCTTCCCAGGTCT
GGTGCATGCTCTTAATGCC: GTGCATGCTCTTAATGCCT
CACCTCCACCGCTGTTTGG: ACCTCCACCGCTGTTTGGG
GGAGTGTCGCACCTAGTGG: GAGTGTCGCACCTAGTGGG
TGTCGAAACCCTGCTGGCG: GTCGAAACCCTGCTGGCGC
ACTATGCTAGTGGTACCCT: CTATGCTAGTGGTACCCTT
GTCCTGCGAGCAATGGTTA: TCCTGCGAGCAATGGTTAT
AGTGTCGCACCGTCAGAGG: GTGTCGCACCGTCAGAGGC
TCGCACCACTGGTTGGCGA: CGCACCACTGGTTGGCGAG
GTTAGACTGCGGAAGGGTT: TTAGACTGCGGAAGGGTTT
GCATCGGAAATGGTGCATG: CATCGGAAATGGTGCATGC
TCCCATGACGTGATTACTC: CCCATGACGTGATTACTCG
TCAGAGGCGGAGTCGACCT: CAGAGGCGGAGTCGACCTC
TGGATAGGCAGAACCTTAG: GGATAGGCAGAACCTTAGG
ACCGAGGGGATCGTTATCT: CCGAGGGGATCGTTATCTA
GCGATGTTAACAGTGGTCA: CGATGTTAACAGTGGTCAC
CCTTGATGTAGGACAGGGG: CTTGATGTAGGACAGGGGA
GAGTCTAGTCAGCTCCATG: AGTCTAGTCAGCTCCATGT
CCTAGTGGGAACAAGTCGA: CTAGTGGGAACAAGTCGAC
GACTGCGGAAGGGTTTCAG: ACTGCGGAAGGGTTTCAGT
ATGCTCTTAATGCCTCCTA: TGCTCTTAATGCCTCCTAG
CGATATTCACCAATGCACC: GATATTCACCAATGCACCT
GTGCCAAGACTCGCGATAC: TGCCAAGACTCGCGATACC
GTGGTCACACGCTTGGCGT: TGGTCACACGCTTGGCGTA
TTAGATAGAAATTGTACAC: TAGATAGAAATTGTACACA
ACAAGCCCGGGGTTCATCT: CAAGCCCGGGGTTCATCTA
TAGTCAGCTCCATGTTTTG: AGTCAGCTCCATGTTTTGC
GATCTATCGACGAGGAAGG: ATCTATCGACGAGGAAGGC
CGCCATTGCTCAGGACTTG: GCCATTGCTCAGGACTTGT
TAGTCTCATCGAGATGCGA: AGTCTCATCGAGATGCGAT
CTTGCTGACGCACACCGGG: TTGCTGACGCACACCGGGC
GATCTTCTAGGGGAGTGTC: ATCTTCTAGGGGAGTGTCG
TGCTGACGCACACCGGGCC: GCTGACGCACACCGGGCCT
CTTCACCACGACCTGAATC: TTCACCACGACCTGAATCC
GGAGCTTGAGTCAAAAGCC: GAGCTTGAGTCAAAAGCCC
ACAGACGAAGCACGTATAC: CAGACGAAGCACGTATACC
CTTGCGATCGGATGGCGCG: TTGCGATCGGATGGCGCGC
GTACTAGTCTCATCGAGAT: TACTAGTCTCATCGAGATG
TCGAAACCCTGCTGGCGCC: CGAAACCCTGCTGGCGCCT
GACTGAAACAGCACAAGAG: ACTGAAACAGCACAAGAGT
GCTATTTTATTGCTCCTTG: CTATTTTATTGCTCCTTGA
CTAATACTGTGGTCAGATC: TAATACTGTGGTCAGATCC
CATATCTGGCTTCATTGCT: ATATCTGGCTTCATTGCTA
TTCCGGTTATAGGGCCCAC: TCCGGTTATAGGGCCCACT
CGTGGAGGGGGCTCGCCAT: GTGGAGGGGGCTCGCCATT
GAATTTTTACACACGTACG: AATTTTTACACACGTACGT
CTGACGGTTCGGTGTGATC: TGACGGTTCGGTGTGATCG
AATATAGAAGGCCCCCTAT: ATATAGAAGGCCCCCTATC
ACGCCTTTACAGCAGTAAG: CGCCTTTACAGCAGTAAGT
TAAATACATTAGAACATAT: AAATACATTAGAACATATT
GAGATCTGGTGCGCTAGGG: AGATCTGGTGCGCTAGGGG
AATGTCGAAACCCTGCTGG: ATGTCGAAACCCTGCTGGC
CCGAGCTCAGCCGGCCTAT: CGAGCTCAGCCGGCCTATA
GTGGTACCCTTGTGAATGG: TGGTACCCTTGTGAATGGG
AACCCGTAAAAGTAGGGGA: ACCCGTAAAAGTAGGGGAC
CTTAAGGTTAATGTCGAAA: TTAAGGTTAATGTCGAAAC
TCTACTAGATTATTCACAA: CTACTAGATTATTCACAAT
ACATTGCGACGTACTAGTC: CATTGCGACGTACTAGTCT
TGTGCTCTAGGTCCGGTGT: GTGCTCTAGGTCCGGTGTC
GTATGCATGTGCTCCGAGC: TATGCATGTGCTCCGAGCT
TACCGGGCCTCAACGCTAG: ACCGGGCCTCAACGCTAGG
AGATGGATAGGCAGAACCT: GATGGATAGGCAGAACCTT
CGTTATCTACGACTAGTTA: GTTATCTACGACTAGTTAC
CCATGAGTTAGACTGCGGA: CATGAGTTAGACTGCGGAA
AGTCATAAGAGTAAGCTGC: GTCATAAGAGTAAGCTGCC
GGCGTAACAAGCGTTCGAA: GCGTAACAAGCGTTCGAAG
ACAACCTAAAGAAGCGAGA: CAACCTAAAGAAGCGAGAA
CTATGCTAGTGGTACCCTT: TATGCTAGTGGTACCCTTG
GTATACCCGCTCAGGATCC: TATACCCGCTCAGGATCCA
CCTTCATCGCGGATGATAA: CTTCATCGCGGATGATAAC
TTCCCACGTCGAGCGCGAA: TCCCACGTCGAGCGCGAAC
TCTCCTAATACTGTGGTCA: CTCCTAATACTGTGGTCAG
ACCATGAGTTAGACTGCGG: CCATGAGTTAGACTGCGGA
ACATGTCTAAACTGCTCAT: CATGTCTAAACTGCTCATG
TACTGAGTCATAAGAGTAA: ACTGAGTCATAAGAGTAAG
GGACAGACGAAGCACGTAT: GACAGACGAAGCACGTATA
GATAAGATCCTATGCGGAT: ATAAGATCCTATGCGGATA
TTCCCATGTGCGCTGCTAC: TCCCATGTGCGCTGCTACG
GATAGGCAGAACCTTAGGG: ATAGGCAGAACCTTAGGGT
ACAAGAAGGGTGCTCTAGA: CAAGAAGGGTGCTCTAGAT
TGTGGTCAGATCCACGCCC: GTGGTCAGATCCACGCCCA
ACTAGATTATTCACAATGA: CTAGATTATTCACAATGAC
GCTCGGTGAGAGCCCACAA: CTCGGTGAGAGCCCACAAT
CGTCCCATCTCGGGCCCCT: GTCCCATCTCGGGCCCCTC
ATATCTTCACCACGACCTG: TATCTTCACCACGACCTGA
GAACGATGTCGCGGAAAAT: AACGATGTCGCGGAAAATC
GTAAGATACCGGGCCTCAA: TAAGATACCGGGCCTCAAC
TGGTTGAACCCGCAAGCTG: GGTTGAACCCGCAAGCTGA
CTATGCGGATACGATATTC: TATGCGGATACGATATTCA
CTAGATTATTCACAATGAC: TAGATTATTCACAATGACC
TTAACAGTAGTTTTGGCGG: TAACAGTAGTTTTGGCGGG
GGATGATAACGACAGCCCG: GATGATAACGACAGCCCGG
ACCCTGCTGGCGCCTACCA: CCCTGCTGGCGCCTACCAG
CACAACCTAAAGAAGCGAG: ACAACCTAAAGAAGCGAGA
CGCGCACTACACAACGTAA: GCGCACTACACAACGTAAC
ACCCGCAAGCTGAGTGCTT: CCCGCAAGCTGAGTGCTTA
GTCGCACCCCACCGATTTA: TCGCACCCCACCGATTTAA
GTTGTCCTCATCGTAATTA: TTGTCCTCATCGTAATTAA
TCCATCGGTTCCGGTAAAT: CCATCGGTTCCGGTAAATA
GAAGGCGCCCAAGCCGGAC: AAGGCGCCCAAGCCGGACA
CTGGCTTCATTGCTAACGC: TGGCTTCATTGCTAACGCG
GCGAGTCGACCTCCGCTTC: CGAGTCGACCTCCGCTTCC
GTTCGCGCCTCTTACCAAA: TTCGCGCCTCTTACCAAAT
ATCTTCACCACGACCTGAA: TCTTCACCACGACCTGAAT
TCGCACCCCACCGATTTAA: CGCACCCCACCGATTTAAG
ACGGGAGCTTGAGTCAAAA: CGGGAGCTTGAGTCAAAAG
TAGGATTATTCAATGTACA: AGGATTATTCAATGTACAG
AGCGAGAAACGCGTATGCA: GCGAGAAACGCGTATGCAT
CAATAGATGGATAGGCAGA: AATAGATGGATAGGCAGAA
CAGAACCTTAGGGTTTTGC: AGAACCTTAGGGTTTTGCT
CATGTCTAAACTGCTCATG: ATGTCTAAACTGCTCATGC
GTAATCGCAGTGTCGTCCT: TAATCGCAGTGTCGTCCTG
GGAGGTTGTTTTTGTGCTC: GAGGTTGTTTTTGTGCTCT
TCGTAATTAACACCCAATC: CGTAATTAACACCCAATCT
CACGTTTATACGGATCTAT: ACGTTTATACGGATCTATC
GCATAATTCAGTGCGTTGT: CATAATTCAGTGCGTTGTC
TAACGTAACACAATCCGCA: AACGTAACACAATCCGCAG
CCAAATCAGGCAAGCACCC: CAAATCAGGCAAGCACCCT
CGAATCCAGCGTATTGCCC: GAATCCAGCGTATTGCCCC
GTCCTCATCGTAATTAACA: TCCTCATCGTAATTAACAC
TTGCTAACGCGGGATCTTC: TGCTAACGCGGGATCTTCT
TCTAGATATCTTCACCACG: CTAGATATCTTCACCACGA
TGACCCTTTACGAAAGAAG: GACCCTTTACGAAAGAAGC
AGAGTGGTTTGAATTTTTA: GAGTGGTTTGAATTTTTAC
CATAATTCAGTGCGTTGTC: ATAATTCAGTGCGTTGTCC
GATCCACGCCCAGACTGAA: ATCCACGCCCAGACTGAAA
AAGAGTAAGCTGCCGGAAT: AGAGTAAGCTGCCGGAATC
ATTAGTCCCCGCGTTCTAC: TTAGTCCCCGCGTTCTACT
TCCCACGTCGAGCGCGAAC: CCCACGTCGAGCGCGAACG
TCGTGGAGGGGGCTCGCCA: CGTGGAGGGGGCTCGCCAT
GCTTCCGGTTATAGGGCCC: CTTCCGGTTATAGGGCCCA
AGTAACGTAACACAATCCG: GTAACGTAACACAATCCGC
ATTAACACCCAATCTTCCG: TTAACACCCAATCTTCCGG
CACACGCTTGGCGTATTAG: ACACGCTTGGCGTATTAGT
CAACTCACGTGAGCGACTG: AACTCACGTGAGCGACTGC
AAATCCATCTTGCGATCGG: AATCCATCTTGCGATCGGA
CACAACCGACATTAAGCCC: ACAACCGACATTAAGCCCA
TCTACTGAGTCATAAGAGT: CTACTGAGTCATAAGAGTA
CTAAACTGCTCATGCACCT: TAAACTGCTCATGCACCTC
AAGACTCGCGATACCCCAA: AGACTCGCGATACCCCAAG
CCCACGTCGAGCGCGAACG: CCACGTCGAGCGCGAACGA
CGTAACGCCTTTACAGCAG: GTAACGCCTTTACAGCAGT
GTGTCGTCCTGCGAGCAAT: TGTCGTCCTGCGAGCAATG
CCTATGCGGATACGATATT: CTATGCGGATACGATATTC
CACACCGGGCCTAATCGCG: ACACCGGGCCTAATCGCGT
CCGAGGGGATCGTTATCTA: CGAGGGGATCGTTATCTAC
AGGGGACCACTCATGTGCA: GGGGACCACTCATGTGCAT
TCCACAAGCCCGGGGTTCA: CCACAAGCCCGGGGTTCAT
TTATTCACAATGACCTTCA: TATTCACAATGACCTTCAT
GTTCCGGTAAATACATTAG: TTCCGGTAAATACATTAGA
GCTCCATGTTTTGCTCATA: CTCCATGTTTTGCTCATAC
CACAAGAGTGTAGTCTTTC: ACAAGAGTGTAGTCTTTCT
GGTTCCGGTAAATACATTA: GTTCCGGTAAATACATTAG
AATTAACACCCAATCTTCC: ATTAACACCCAATCTTCCG
CCCACCGATTTAAGTCGAC: CCACCGATTTAAGTCGACC
CGAGATGCGATGAGAGTGG: GAGATGCGATGAGAGTGGT
CGCCTACCAGGCTGCTTGT: GCCTACCAGGCTGCTTGTT
TCACCATGAGTTAGACTGC: CACCATGAGTTAGACTGCG
GGTCAGATCCACGCCCAGA: GTCAGATCCACGCCCAGAC
ATGAGAGTGGTTTGAATTT: TGAGAGTGGTTTGAATTTT
AGGGGGAGTCATCCAGAGT: GGGGGAGTCATCCAGAGTC
CTCACTGACGGTTCGGTGT: TCACTGACGGTTCGGTGTG
TAATGTCGAAACCCTGCTG: AATGTCGAAACCCTGCTGG
CCCTCATCAGCCGTTCGCG: CCTCATCAGCCGTTCGCGC
GGTCTAGGCTATTTTATTG: GTCTAGGCTATTTTATTGC
GTTCCCACGTCGAGCGCGA: TTCCCACGTCGAGCGCGAA
TTCTTAGGATCAAACAGTA: TCTTAGGATCAAACAGTAA
GAGACACAACCTAAAGAAG: AGACACAACCTAAAGAAGC
CACGACCTGAATCCCTCAT: ACGACCTGAATCCCTCATC
CACCAATGCACCTGGTGAC: ACCAATGCACCTGGTGACT
AAGGCCCCCTATCCTATGT: AGGCCCCCTATCCTATGTC
AGCCGGCCTATAAGGAAAC: GCCGGCCTATAAGGAAACG
GGAGATCTGGTGCGCTAGG: GAGATCTGGTGCGCTAGGG
ATACGATATTCACCAATGC: TACGATATTCACCAATGCA
TGACTAGGGGAGTGTCGCA: GACTAGGGGAGTGTCGCAC
TATTCACAATGACCTTCAT: ATTCACAATGACCTTCATC
TGCTCATACGAATCCAGCG: GCTCATACGAATCCAGCGT
TTTACACACGTACGTTAAT: TTACACACGTACGTTAATT
GGTCACACGCTTGGCGTAT: GTCACACGCTTGGCGTATT
CAGTAGTTTTGGCGGGTGA: AGTAGTTTTGGCGGGTGAT
CCTCATCAGCCGTTCGCGC: CTCATCAGCCGTTCGCGCC
TAACACCCAATCTTCCGGG: AACACCCAATCTTCCGGGG
CCAGGTCTCGTGAGGCATG: CAGGTCTCGTGAGGCATGA
TAAGAGTAAGCTGCCGGAA: AAGAGTAAGCTGCCGGAAT
AGTGTAGTCTTTCTTAGGA: GTGTAGTCTTTCTTAGGAT
CACTGGTTGGCGAGTCGAC: ACTGGTTGGCGAGTCGACC
TGAGTCATAAGAGTAAGCT: GAGTCATAAGAGTAAGCTG
AAGGGTGCTCTAGATATCT: AGGGTGCTCTAGATATCTT
CCCTTTACGAAAGAAGCCT: CCTTTACGAAAGAAGCCTC
CATCGTAATTAACACCCAA: ATCGTAATTAACACCCAAT
GCACTACACAACGTAACGC: CACTACACAACGTAACGCC
ATCTTGCGATCGGATGGCG: TCTTGCGATCGGATGGCGC
TCACTGACATCCGTGTTGC: CACTGACATCCGTGTTGCC
ATGATAACGACAGCCCGGC: TGATAACGACAGCCCGGCT
GCGTAACAAGCGTTCGAAG: CGTAACAAGCGTTCGAAGA
TTCAGTCCGGCTTCCGGTT: TCAGTCCGGCTTCCGGTTA
TGTCGCACCACTGGTTGGC: GTCGCACCACTGGTTGGCG
CGATAAGATCCTATGCGGA: GATAAGATCCTATGCGGAT
GATATTCACCAATGCACCT: ATATTCACCAATGCACCTG
AGAACATGTCTAAACTGCT: GAACATGTCTAAACTGCTC
TCTTGCGATCGGATGGCGC: CTTGCGATCGGATGGCGCG
TTGCGATCGGATGGCGCGC: TGCGATCGGATGGCGCGCA
AGTCGACTACAAGAAGGGT: GTCGACTACAAGAAGGGTG
ATTTCACCATGAGTTAGAC: TTTCACCATGAGTTAGACT
CACAACGTAACGCCTTTAC: ACAACGTAACGCCTTTACA
CGTACGATAAGATCCTATG: GTACGATAAGATCCTATGC
AAAAGCCCTCAGCGGGTAC: AAAGCCCTCAGCGGGTACC
CAAAGAAAAGTAGACCTTC: AAAGAAAAGTAGACCTTCC
AGAAACGCGTATGCATGTG: GAAACGCGTATGCATGTGC
GAAGGCCCCCTATCCTATG: AAGGCCCCCTATCCTATGT
ACAACGTAACGCCTTTACA: CAACGTAACGCCTTTACAG
GGGGGAGTCATCCAGAGTC: GGGGAGTCATCCAGAGTCT
GCCCACTTTAATACGAGCA: CCCACTTTAATACGAGCAT
GATCGTGGAGGGGGCTCGC: ATCGTGGAGGGGGCTCGCC
ACTTCATTTACGGAGATCT: CTTCATTTACGGAGATCTG
ATGTCGAAACCCTGCTGGC: TGTCGAAACCCTGCTGGCG
TGCCCCGTACGTACGATAA: GCCCCGTACGTACGATAAG
GTGACTATGCTAGTGGTAC: TGACTATGCTAGTGGTACC
TCATCTACTAGATTATTCA: CATCTACTAGATTATTCAC
CCTTTACGAAAGAAGCCTC: CTTTACGAAAGAAGCCTCT
CTACGAACACTGACAAAGG: TACGAACACTGACAAAGGG
CACCCCACCGATTTAAGTC: ACCCCACCGATTTAAGTCG
CACTGACATCCGTGTTGCC: ACTGACATCCGTGTTGCCG
TTGACTAGGGGAGTGTCGC: TGACTAGGGGAGTGTCGCA
TCTTCCGGGGGGTTTAGAT: CTTCCGGGGGGTTTAGATA
CAACCGACATTAAGCCCAT: AACCGACATTAAGCCCATA
TGGCGGGTGATTCCATCGG: GGCGGGTGATTCCATCGGT
CATCTTGCGATCGGATGGC: ATCTTGCGATCGGATGGCG
AGCCGTTCGCGCCTCTTAC: GCCGTTCGCGCCTCTTACC
GGGGATCGTTATCTACGAC: GGGATCGTTATCTACGACT
AAACTGCTCATGCACCTCC: AACTGCTCATGCACCTCCA
GGTACCCTTGTGAATGGGT: GTACCCTTGTGAATGGGTT
ATATTCACCAATGCACCTG: TATTCACCAATGCACCTGG
CATGACCCTTTACGAAAGA: ATGACCCTTTACGAAAGAA
CCATACTTCATTTACGGAG: CATACTTCATTTACGGAGA
ACGATAAGATCCTATGCGG: CGATAAGATCCTATGCGGA
GAGTGGTTTGAATTTTTAC: AGTGGTTTGAATTTTTACA
GTACCCAGGCAGTAGACCG: TACCCAGGCAGTAGACCGA
TATTCAATGTACAGGGGGA: ATTCAATGTACAGGGGGAG
CTAGTCAGCTCCATGTTTT: TAGTCAGCTCCATGTTTTG
CAGTCGACTACAAGAAGGG: AGTCGACTACAAGAAGGGT
CCTCCACCGCTGTTTGGGC: CTCCACCGCTGTTTGGGCT
GTGTAGTCTTTCTTAGGAT: TGTAGTCTTTCTTAGGATC
TAATCGCGTAAGATACCGG: AATCGCGTAAGATACCGGG
CCCAAGAATTGAGACACAA: CCAAGAATTGAGACACAAC
TTCCGGGGGGTTTAGATAG: TCCGGGGGGTTTAGATAGA
CGGTGTCACAACGTCCCAT: GGTGTCACAACGTCCCATC
CTATGTCACTGACATCCGT: TATGTCACTGACATCCGTG
TACGGGAGCTTGAGTCAAA: ACGGGAGCTTGAGTCAAAA
CTTACCAAATCAGGCAAGC: TTACCAAATCAGGCAAGCA
AGCGCGAACGATGTCGCGG: GCGCGAACGATGTCGCGGA
ACTGCGTAGACAGTCGACT: CTGCGTAGACAGTCGACTA
TGTTAAATAATATAGAAGG: GTTAAATAATATAGAAGGC
CGATGTCGCGGAAAATCCA: GATGTCGCGGAAAATCCAT
AGTCCGGCTTCCGGTTATA: GTCCGGCTTCCGGTTATAG
GAGCTCAGCCGGCCTATAA: AGCTCAGCCGGCCTATAAG
CCATTGCTCAGGACTTGTT: CATTGCTCAGGACTTGTTC
TATCTACGACTAGTTACGG: ATCTACGACTAGTTACGGT
TTACTTAGTTTGACTAGGG: TACTTAGTTTGACTAGGGG
ACCCGCTCAGGATCCACAA: CCCGCTCAGGATCCACAAG
CCACGTTTATACGGATCTA: CACGTTTATACGGATCTAT
GCTTCCCATGACGTGATTA: CTTCCCATGACGTGATTAC
TAGTTACGGTTGAATGTTT: AGTTACGGTTGAATGTTTT
AAAAGTAGACCTTCCACGT: AAAGTAGACCTTCCACGTT
CTTTCTTAGGATCAAACAG: TTTCTTAGGATCAAACAGT
TGGTACCCTTGTGAATGGG: GGTACCCTTGTGAATGGGT
GGTGGCTCTTTACTTAGTT: GTGGCTCTTTACTTAGTTT
ATGTTTTGCTCATACGAAT: TGTTTTGCTCATACGAATC
CCTTTGTTAAACACAACCG: CTTTGTTAAACACAACCGA
TCATAAGAGTAAGCTGCCG: CATAAGAGTAAGCTGCCGG
AGCTGAGTGCTTAAGGTTA: GCTGAGTGCTTAAGGTTAA
AGTGTCGCACCACTGGTTG: GTGTCGCACCACTGGTTGG
CACAGAAATATGGCGTAAC: ACAGAAATATGGCGTAACA
GAGGTTGTTTTTGTGCTCT: AGGTTGTTTTTGTGCTCTA
GAATCCAGCGTATTGCCCC: AATCCAGCGTATTGCCCCG
CCCCACCGATTTAAGTCGA: CCCACCGATTTAAGTCGAC
GTATTAGTCCCCGCGTTCT: TATTAGTCCCCGCGTTCTA
TACCTAATGGTCTCACTGA: ACCTAATGGTCTCACTGAC
GCAAGCACCCTTTGTTAAA: CAAGCACCCTTTGTTAAAC
GAAACGCGTATGCATGTGC: AAACGCGTATGCATGTGCT
AGTGCTTAAGGTTAATGTC: GTGCTTAAGGTTAATGTCG
TCCACGCCCAGACTGAAAC: CCACGCCCAGACTGAAACA
ATGTACAGGGGGAGTCATC: TGTACAGGGGGAGTCATCC
CCTAATCGCGTAAGATACC: CTAATCGCGTAAGATACCG
CGGGTGATTCCATCGGTTC: GGGTGATTCCATCGGTTCC
CCCCGCGTTCTACTGAGTC: CCCGCGTTCTACTGAGTCA
GCTTCCCAGGTGGCTCTTT: CTTCCCAGGTGGCTCTTTA
CCATCTCGGGCCCCTCTTA: CATCTCGGGCCCCTCTTAG
GACTAGTTACGGTTGAATG: ACTAGTTACGGTTGAATGT
ACAACACCAACTCACGTGA: CAACACCAACTCACGTGAG
GGGGACCACTCATGTGCAT: GGGACCACTCATGTGCATC
TACCCCAAGAATTGAGACA: ACCCCAAGAATTGAGACAC
GTTTGACTAGGGGAGTGTC: TTTGACTAGGGGAGTGTCG
TACTAGTCTCATCGAGATG: ACTAGTCTCATCGAGATGC
ATTCCATCGGTTCCGGTAA: TTCCATCGGTTCCGGTAAA
TGTGATCGTGGAGGGGGCT: GTGATCGTGGAGGGGGCTC
CAGTGTCGTCCTGCGAGCA: AGTGTCGTCCTGCGAGCAA
TGCGCTGCTACGAACACTG: GCGCTGCTACGAACACTGA
TCAAAAGCCCTCAGCGGGT: CAAAAGCCCTCAGCGGGTA
CATCTCGGGCCCCTCTTAG: ATCTCGGGCCCCTCTTAGC
TAACGCCTTTACAGCAGTA: AACGCCTTTACAGCAGTAA
ATTGCGACGTACTAGTCTC: TTGCGACGTACTAGTCTCA
CCGTAAAAGTAGGGGACCA: CGTAAAAGTAGGGGACCAC
TTTAGATAGAAATTGTACA: TTAGATAGAAATTGTACAC
GCACCGTCAGAGGCGGAGT: CACCGTCAGAGGCGGAGTC
ATGGTCTCACTGACGGTTC: TGGTCTCACTGACGGTTCG
CGGATACGATATTCACCAA: GGATACGATATTCACCAAT
TAAAAGTAGGGGACCACTC: AAAAGTAGGGGACCACTCA
GCTCAGGATCCACAAGCCC: CTCAGGATCCACAAGCCCG
GTGGTTTGAATTTTTACAC: TGGTTTGAATTTTTACACA
ATTACTCGTGAGCGCTCGG: TTACTCGTGAGCGCTCGGT
GCACGTATACCCGCTCAGG: CACGTATACCCGCTCAGGA
TCCGGTGTCACAACGTCCC: CCGGTGTCACAACGTCCCA
GGAAGGGTTTCAGTCCGGC: GAAGGGTTTCAGTCCGGCT
GCGCACATTGCGACGTACT: CGCACATTGCGACGTACTA
TACTTCATTTACGGAGATC: ACTTCATTTACGGAGATCT
CTAATGGTCTCACTGACGG: TAATGGTCTCACTGACGGT
TTATTCAATGTACAGGGGG: TATTCAATGTACAGGGGGA
TGCCGGTCCAGGAGGTTGT: GCCGGTCCAGGAGGTTGTT
TGTCCTCATCGTAATTAAC: GTCCTCATCGTAATTAACA
ACTTGTTCCCACGTCGAGC: CTTGTTCCCACGTCGAGCG
ATGCCTCCTAGGGGAGTGT: TGCCTCCTAGGGGAGTGTC
GTTAAACACAACCGACATT: TTAAACACAACCGACATTA
ATGGATAGGCAGAACCTTA: TGGATAGGCAGAACCTTAG
CGTTCGCGCCTCTTACCAA: GTTCGCGCCTCTTACCAAA
ACAAGAGTGTAGTCTTTCT: CAAGAGTGTAGTCTTTCTT
CGACAGCCCGGCTATACGG: GACAGCCCGGCTATACGGG
CGACCTCCGCTTCCCATGT: GACCTCCGCTTCCCATGTG
ATTGCCCCGTACGTACGAT: TTGCCCCGTACGTACGATA
TCTCGGGCCCCTCTTAGCG: CTCGGGCCCCTCTTAGCGG
ATTAAGCCCATACTTCATT: TTAAGCCCATACTTCATTT
GGGACATGGGTGCCAAGAC: GGACATGGGTGCCAAGACT
AACAAGTCGACCTCCGCTT: ACAAGTCGACCTCCGCTTC
CGTGAGGCATGACCCTTTA: GTGAGGCATGACCCTTTAC
GCATGACCCTTTACGAAAG: CATGACCCTTTACGAAAGA
GGATCCACAAGCCCGGGGT: GATCCACAAGCCCGGGGTT
GTGCTTAAGGTTAATGTCG: TGCTTAAGGTTAATGTCGA
ATACGGATCTATCGACGAG: TACGGATCTATCGACGAGG
TTTATACGGATCTATCGAC: TTATACGGATCTATCGACG
CGATTTAAGTCGACCTCCG: GATTTAAGTCGACCTCCGC
AGAGCCCACAATAGATGGA: GAGCCCACAATAGATGGAT
CAACCTAAAGAAGCGAGAA: AACCTAAAGAAGCGAGAAA
AACACTGACAAAGGGACAT: ACACTGACAAAGGGACATG
TGCATGGTAATCGCAGTGT: GCATGGTAATCGCAGTGTC
ACGTCGAGCGCGAACGATG: CGTCGAGCGCGAACGATGT
CTGAGTCATAAGAGTAAGC: TGAGTCATAAGAGTAAGCT
GGTGCTCTAGATATCTTCA: GTGCTCTAGATATCTTCAC
TCCGGTTATAGGGCCCACT: CCGGTTATAGGGCCCACTT
CGGAGTCGACCTCCGCTTC: GGAGTCGACCTCCGCTTCC
CCCAGACTGAAACAGCACA: CCAGACTGAAACAGCACAA
TGCATCGGAAATGGTGCAT: GCATCGGAAATGGTGCATG
TGCATGTGCTCCGAGCTCA: GCATGTGCTCCGAGCTCAG
CGTAGACAGTCGACTACAA: GTAGACAGTCGACTACAAG
AAATCCTCGCGCACATTGC: AATCCTCGCGCACATTGCG
ACTTAGTTTGACTAGGGGA: CTTAGTTTGACTAGGGGAG
TGCGATGTTAACAGTGGTC: GCGATGTTAACAGTGGTCA
CAATGTACAGGGGGAGTCA: AATGTACAGGGGGAGTCAT
TTTACTTAGTTTGACTAGG: TTACTTAGTTTGACTAGGG
TGGTTATCGGTCTAGGCTA: GGTTATCGGTCTAGGCTAT
TCGGACAACACCAACTCAC: CGGACAACACCAACTCACG
CACTGACGGTTCGGTGTGA: ACTGACGGTTCGGTGTGAT
TCGACTACAAGAAGGGTGC: CGACTACAAGAAGGGTGCT
CGGTTCGGTGTGATCGTGG: GGTTCGGTGTGATCGTGGA
GCTGACGCACACCGGGCCT: CTGACGCACACCGGGCCTA
CTGCGGAAGGGTTTCAGTC: TGCGGAAGGGTTTCAGTCC
ATACCCGCTCAGGATCCAC: TACCCGCTCAGGATCCACA
ATCTTCTAGGGGAGTGTCG: TCTTCTAGGGGAGTGTCGC
CAGAGTCTAGTCAGCTCCA: AGAGTCTAGTCAGCTCCAT
AAGTAGACCTTCCACGTTT: AGTAGACCTTCCACGTTTA
GGGCCTCAACGCTAGGATT: GGCCTCAACGCTAGGATTA
TCTCGTGAGGCATGACCCT: CTCGTGAGGCATGACCCTT
AAGCACCCTTTGTTAAACA: AGCACCCTTTGTTAAACAC
TTCAATGTACAGGGGGAGT: TCAATGTACAGGGGGAGTC
GCCCCGTACGTACGATAAG: CCCCGTACGTACGATAAGA
CTCCTAGGGGAGTGTCGCA: TCCTAGGGGAGTGTCGCAC
AGGTCCGGTGTCACAACGT: GGTCCGGTGTCACAACGTC
CGCTCGGTGAGAGCCCACA: GCTCGGTGAGAGCCCACAA
TTAAACCCGTAAAAGTAGG: TAAACCCGTAAAAGTAGGG
GGTTCATCTACTAGATTAT: GTTCATCTACTAGATTATT
TGTTGCCGGTCCAGGAGGT: GTTGCCGGTCCAGGAGGTT
TATCTTCACCACGACCTGA: ATCTTCACCACGACCTGAA
GGCCTCAACGCTAGGATTA: GCCTCAACGCTAGGATTAT
TCACTGACGGTTCGGTGTG: CACTGACGGTTCGGTGTGA
AGCTTGAGTCAAAAGCCCT: GCTTGAGTCAAAAGCCCTC
CTTCTAGGGGAGTGTCGCA: TTCTAGGGGAGTGTCGCAC
GCTCTAGATATCTTCACCA: CTCTAGATATCTTCACCAC
TAGATTATTCACAATGACC: AGATTATTCACAATGACCT
AGGGGAGTGTCGCACCTAG: GGGGAGTGTCGCACCTAGT
AACAGTAGTTTTGGCGGGT: ACAGTAGTTTTGGCGGGTG
ACACACGTACGTTAATTTC: CACACGTACGTTAATTTCA
CGCTTCCCAGGTGGCTCTT: GCTTCCCAGGTGGCTCTTT
